CAGAAATACAGTGCGACCTG	CAGAAATACAGTGCGACCTG	1	0
CGATCCACAATTTTAAAAGA	CGATCCACAATTTTAAAAGA	1	0
ATCACATCTGTTTTAGAGCT	ATCACATCTGTTTTAGAGCT	1	0
TGTTGCAAGGCTAGTCCGTT	TGTTGCAAGGCTAGTCCGTT	1	0
CCAGAACGACCACGTCTGTT	CCAGAACGACCACGTCTGTT	1	0
TACCTTGGATCACTTACATC	TACCTTGGATCACTTACATC	1	0
CTTCAAGCTGTAATTCCGTA	CTTCAAGCTGTAATTCCGTA	1	0
TGAAAGTACTAGAAAACGTG	TGAAAGTACTAGAAAACGTG	1	0
TCTCACCGTGCTGTCACATT	TCTCACCGTGCTGTCACATT	1	0
GGGCGATGCACCGTTAATCG	GGGCGATGCACCGTTAATCG	1	0
CAGCTACTTCTTCCTTGCGC	CAGCTACTTCTTCCTTGCGC	1	0
CCTCTGACCTCAAGTTAAAA	CCTCTGACCTCAAGTTAAAA	1	0
TCTCCAAAATAAGGCTAGTC	TCTCCAAAATAAGGCTAGTC	5	0
TCCGCCGGGCGATCCGCCTG	TCCGCCGGGCGATCCGCCTG	1	0
CCCATCTCTTGTCTCTGTTT	CCCATCTCTTGTCTCTGTTT	1	0
CCCACCACTTATTTTTCCAC	CCCACCACTTATTTTTCCAC	1	0
TAAGCACGTTCGAGTCCATG	TAAGCACGTTCGAGTCCATG	1	0
ATTAGAGCTAGAAATAGCAA	ATTAGAGCTAGAAATAGCAA	1	0
TACGCTGACCTCCGCAACCT	TACGCTGACCTCCGCAACCT	1	0
GACTCCTATCATCATGTCGG	GACTCCTATCATCATGTCGG	4	0
CTACACAGATCCTTCCGTGA	CTACACAGATCCTTCCGTGA	1	0
ATCTTTCATGTCGAGACACA	ATCTTTCATGTCGAGACACA	1	0
CTTCACGATGCCAGCCGTTT	CTTCACGATGCCAGCCGTTT	1	0
ACCCGCGTCCTCGTCGTCGA	ACCCGCGTCCTCGTCGTCGA	1	0
TCCGCGCTTCCAGCCGCTCC	TCCGCGCTTCCAGCCGCTCC	1	0
TGTTCTTACCTGTGTTCGCG	TGTTCTTACCTGTGTTCGCG	1	0
TAGCCAGAAAACTTTACTCT	TAGCCAGAAAACTTTACTCT	1	0
CTCAAAATAGCGAGTTAAAA	CTCAAAATAGCGAGTTAAAA	5	0
CTCCAACCGTCCGTTATCAA	CTCCAACCGTCCGTTATCAA	2	0
CCGCGCACCACCGAGTCGGT	CCGCGCACCACCGAGTCGGT	3	0
TTTTGGGAGTACCGTGGACT	TTTTGGGAGTACCGTGGACT	1	0
AGTCCTGTCCCATGCGATTG	AGTCCTGTCCCATGCGATTG	1	0
CGCTGCCATCAACTTGAAAA	CGCTGCCATCAACTTGAAAA	6	0
CCTGCGTCCCGTGCAGGTGA	CCTGCGTCCCGTGCAGGTGA	1	0
GGGTAGTGACCCGTCCGTTA	GGGTAGTGACCCGTCCGTTA	2	1
CTTCAGTCCAAATGTAGCCG	CTTCAGTCCAAATGTAGCCG	1	0
CATGCCTCTTCATAGTTAAG	CATGCCTCTTCATAGTTAAG	1	0
TTCAGCAAGTTAAAATAAGG	TTCAGCAAGTTAAAATAAGG	6	0
CACGCTGACCCAGCCTATCG	CACGCTGACCCAGCCTATCG	1	0
TGCCGTCTTGGCGGGCCCCC	TGCCGTCTTGGCGGGCCCCC	1	0
CACGGTAACGGAGCGATTTG	CACGGTAACGGAGCGATTTG	1	0
TCCTCTCATGTGAAGTTATT	TCCTCTCATGTGAAGTTATT	1	0
CCAGCTTGTTCCTCTCCCCC	CCAGCTTGTTCCTCTCCCCC	1	0
GCTGTACCTGGAAAATCATG	GCTGTACCTGGAAAATCATG	1	0
TGCTTGGGCCGCTCCTCACA	TGCTTGGGCCGCTCCTCACA	1	0
GGGCAAGTCCGTTATCAACT	GGGCAAGTCCGTTATCAACT	4	6
GATGACACACCTGACCAGCC	GATGACACACCTGACCAGCC	1	0
TCTACATCTCCGACCACGTT	TCTACATCTCCGACCACGTT	1	0
CTGTCCGTTCTCAACTTGAA	CTGTCCGTTCTCAACTTGAA	4	0
GCAGAAGCGAGTAACATCGG	GCAGAAGCGAGTAACATCGG	1	0
GTGTCAATGGTCCATCGTTT	GTGTCAATGGTCCATCGTTT	1	0
TTATCGGCAGGCTATCCGTT	TTATCGGCAGGCTATCCGTT	3	0
CTGGAGTCACCCTACGTTGG	CTGGAGTCACCCTACGTTGG	1	0
TGCGTCAGTCGCCTACCTGT	TGCGTCAGTCGCCTACCTGT	1	0
GCTCACTCTCGCTCCTGTTT	GCTCACTCTCGCTCCTGTTT	1	0
CCAGTATTCCCACAATTTTA	CCAGTATTCCCACAATTTTA	1	0
CACTGTCCTGCACCGCCGTT	CACTGTCCTGCACCGCCGTT	1	0
AGATCATTGCTTTAGAGCTA	AGATCATTGCTTTAGAGCTA	1	0
CGATGACGTTACCGCAGCCG	CGATGACGTTACCGCAGCCG	1	0
ACCTTAATATTTGCCTCATC	ACCTTAATATTTGCCTCATC	1	0
GCTGCGAGCCCGTTATCAAC	GCTGCGAGCCCGTTATCAAC	4	0
TCCGGACGGTCTGCACGTGT	TCCGGACGGTCTGCACGTGT	2	0
CCCGTTTTAGTCTCAGCCCC	CCCGTTTTAGTCTCAGCCCC	1	0
GCTGTAGATCCGTCCGTCAG	GCTGTAGATCCGTCCGTCAG	1	0
TCGCTGTTCTCCTCCGTTTT	TCGCTGTTCTCCTCCGTTTT	1	0
TTGCCCTACAGATGCCTTCT	TTGCCCTACAGATGCCTTCT	1	0
CCACGGTGTTCATGCATGTG	CCACGGTGTTCATGCATGTG	1	0
GATGGCATCAATGAATCGCG	GATGGCATCAATGAATCGCG	1	0
CGGAGGCTCAAACATCGCGT	CGGAGGCTCAAACATCGCGT	2	0
ATTCCTTATCCCACCATCTC	ATTCCTTATCCCACCATCTC	1	0
GGTTTACAACTTGGAAAAGT	GGTTTACAACTTGGAAAAGT	1	0
GTCAGACCTAGTACCGCTAG	GTCAGACCTAGTACCGCTAG	1	0
CGTACGACCTGACAGCCAAG	CGTACGACCTGACAGCCAAG	1	0
GGCACGTTATCAACTTGAAA	GGCACGTTATCAACTTGAAA	5	0
TCACGACGCCGCCCCACTGG	TCACGACGCCGCCCCACTGG	1	0
CTATAACCACCTAGTACGTT	CTATAACCACCTAGTACGTT	1	0
CAACAAGCCATCAACGCCAG	CAACAAGCCATCAACGCCAG	1	0
TGACCAGCCACGCCCCTACA	TGACCAGCCACGCCCCTACA	1	0
TTGCAGGTCATTTGATCTTG	TTGCAGGTCATTTGATCTTG	1	0
TCGAAACCACAGATGTCCCT	TCGAAACCACAGATGTCCCT	1	0
TCTGTACGCGTGTTCCTTTG	TCTGTACGCGTGTTCCTTTG	1	0
CAGACACAGCGAGTCCGTTA	CAGACACAGCGAGTCCGTTA	2	0
ACCTGCAACGCTGCGCGCCG	ACCTGCAACGCTGCGCGCCG	1	0
GCTCGAGCAGCACACATCAT	GCTCGAGCAGCACACATCAT	1	0
ACGGGCTTGCCTTGACAAGT	ACGGGCTTGCCTTGACAAGT	1	0
TTTTCCGATTCCCGAGACCG	TTTTCCGATTCCCGAGACCG	1	0
CCGAGCGCATATGCCCAAGT	CCGAGCGCATATGCCCAAGT	1	0
AACCTTCAAAGGCCATCGTT	AACCTTCAAAGGCCATCGTT	1	0
ATATCGCTCTATTCTCCATG	ATATCGCTCTATTCTCCATG	1	0
CTCACTCATATCTTTCCTGT	CTCACTCATATCTTTCCTGT	2	0
TCCAGAGAATTGTCATTTCG	TCCAGAGAATTGTCATTTCG	1	0
CCATTTTGGCTTCCACTTCC	CCATTTTGGCTTCCACTTCC	1	0
CTCCTGGGGCTTCTCAATCT	CTCCTGGGGCTTCTCAATCT	1	0
ACCCGATGAGCTGCGTCTCC	ACCCGATGAGCTGCGTCTCC	2	0
GTGCTAGAGATAGCAAGTTA	GTGCTAGAGATAGCAAGTTA	1	0
CGCTGGCAAGTTAAAATAAG	CGCTGGCAAGTTAAAATAAG	2	0
ATCACATATCTTCATATTCC	ATCACATATCTTCATATTCC	1	0
CAATATTCTGAACTCCCCCG	CAATATTCTGAACTCCCCCG	1	0
TCCTCACCGTCAATCGCTAC	TCCTCACCGTCAATCGCTAC	1	0
GTCGCGCCACCCTTCCGTTT	GTCGCGCCACCCTTCCGTTT	1	0
CACTCTGTTTTTCAGCGTTC	CACTCTGTTTTTCAGCGTTC	1	0
TGCACGCTACTCCGTTATCA	TGCACGCTACTCCGTTATCA	10	0
CTGGGGTACCGAGTCGGTGC	CTGGGGTACCGAGTCGGTGC	1	0
TGAAATGTCTTCTAGATTTG	TGAAATGTCTTCTAGATTTG	1	0
ACCACCTAGAAATAGCAAGT	ACCACCTAGAAATAGCAAGT	1	0
TGCAGGCGGACACGATAGCC	TGCAGGCGGACACGATAGCC	1	0
CTGGACCACATAGTGACCTG	CTGGACCACATAGTGACCTG	1	0
TATTGCCCAGTGCGTCCACG	TATTGCCCAGTGCGTCCACG	1	0
TTCCCCTGATGCTCGTTTTA	TTCCCCTGATGCTCGTTTTA	1	0
CCCAGATAGCAAGTTAAAAT	CCCAGATAGCAAGTTAAAAT	1	1
GGACACGGTAGACGCTATCC	GGACACGGTAGACGCTATCC	1	0
TGACCACGTTCCCCCTGCAG	TGACCACGTTCCCCCTGCAG	3	0
GGCAATGAGGCTAGTCCGTT	GGCAATGAGGCTAGTCCGTT	2	0
ACCTTGCAACTTCACTGGTT	ACCTTGCAACTTCACTGGTT	1	0
TGTCCAACAGCGTCTCGTTT	TGTCCAACAGCGTCTCGTTT	1	0
CGGCAGTTATATCAAGGCCA	CGGCAGTTATATCAAGGCCA	1	0
ACCGAAGGTCCTTGAACAGT	ACCGAAGGTCCTTGAACAGT	1	0
GTTGGGCTCTGCGTCCTTCG	GTTGGGCTCTGCGTCCTTCG	1	0
CGCACCATCTCCCGGGGGTC	CGCACCATCTCCCGGGGGTC	1	0
CCATACTTCAGCGCAAGAAA	CCATACTTCAGCGCAAGAAA	1	0
CTGATTGAAACTCTTGTCAA	CTGATTGAAACTCTTGTCAA	1	0
ACTTACAACCCCGTCTCAGG	ACTTACAACCCCGTCTCAGG	1	0
ATCGGGCACAATACCACACT	ATCGGGCACAATACCACACT	1	0
GCTGGTCCGTTATCAACTTG	GCTGGTCCGTTATCAACTTG	1	0
AACCAGGGAGTGATGTTTTC	AACCAGGGAGTGATGTTTTC	1	0
ACTCACCCCACAGCATCCGT	ACTCACCCCACAGCATCCGT	1	0
ATGGGGTACCGAGTCGGTGC	ATGGGGTACCGAGTCGGTGC	1	0
GCACTATACTGCTTTGTCTT	GCACTATACTGCTTTGTCTT	1	0
CACCAGGGTTTCATTAACCT	CACCAGGGTTTCATTAACCT	1	0
ACTTGGTGAAGGGCAGGCCG	ACTTGGTGAAGGGCAGGCCG	4	0
CTGCACCACGTGCACCTCAT	CTGCACCACGTGCACCTCAT	1	0
CCTCGGTCCACACCGCCCAC	CCTCGGTCCACACCGCCCAC	1	0
GCAACTTGAAAAAGTGGCAC	GCAACTTGAAAAAGTGGCAC	1	0
ACCATTGCAGGTGCGGTTCA	ACCATTGCAGGTGCGGTTCA	1	0
CTGACACTTATATCTTATCT	CTGACACTTATATCTTATCT	1	0
CCCTGTGCAGCTATCCGTTA	CCCTGTGCAGCTATCCGTTA	2	0
CCGCTTCCACGTGTTCGACT	CCGCTTCCACGTGTTCGACT	1	0
CACGTCAAGAGCACGACCAG	CACGTCAAGAGCACGACCAG	1	0
TCGGCCTGGCGATATGGGCT	TCGGCCTGGCGATATGGGCT	1	0
AGGAACTGGATTTTTTATTG	AGGAACTGGATTTTTTATTG	1	0
AGTGTTGTCTGTGTCAGTGT	AGTGTTGTCTGTGTCAGTGT	1	0
TTAATGCATCTCAGCTGTTA	TTAATGCATCTCAGCTGTTA	1	0
GCGCCGCATTTAGAGCTAGA	GCGCCGCATTTAGAGCTAGA	1	0
TTGGGACATAGGTCTATCCG	TTGGGACATAGGTCTATCCG	1	0
CATAAAGCCATGGCTTGCCG	CATAAAGCCATGGCTTGCCG	1	0
GGGGTGGCTAACGTCCCGCG	GGGGTGGCTAACGTCCCGCG	1	0
TTCTTACCTTGGGGGTAGTC	TTCTTACCTTGGGGGTAGTC	6	0
CCGCAGAACCAAGTTAAAAT	CCGCAGAACCAAGTTAAAAT	1	0
TGACTGATTACCCGACTCCG	TGACTGATTACCCGACTCCG	1	0
GCGGGCGCACATGTCGCCTT	GCGGGCGCACATGTCGCCTT	1	0
CTTCAGGGTCTTTCCCCCTG	CTTCAGGGTCTTTCCCCCTG	1	0
AGCAACTTGAAAAAGTGGCA	AGCAACTTGAAAAAGTGGCA	4	0
CTGCTGTGCCGTGTGTGCTG	CTGCTGTGCCGTGTGTGCTG	2	0
TTTTAGAGCTAGAAATAGCA	TTTTAGAGCTAGAAATAGCA	1	2
TAGCCCCAGTAGTCCGTTAT	TAGCCCCAGTAGTCCGTTAT	4	0
CCAGGATGCCCGAATCCTCG	CCAGGATGCCCGAATCCTCG	1	0
GCTGCGAGCCCGTTCTCAAC	GCTGCGAGCCCGTTCTCAAC	1	0
TTGAACCATGTCACGGCCCT	TTGAACCATGTCACGGCCCT	1	0
CTTCTGCGAGCAGCTCACGG	CTTCTGCGAGCAGCTCACGG	1	0
ACAGATTATGCGAGAATGTC	ACAGATTATGCGAGAATGTC	1	0
CTCGCATTTGGTGATACACG	CTCGCATTTGGTGATACACG	1	0
ACCCGCCACATGCAGCTCGC	ACCCGCCACATGCAGCTCGC	1	0
CGAAGAGGGTTTGAGCCCAT	CGAAGAGGGTTTGAGCCCAT	1	0
GTACCAGCCGTCCGCCTCGT	GTACCAGCCGTCCGCCTCGT	1	0
TGTAGGAAAGACTTGAAACA	TGTAGGAAAGACTTGAAACA	1	0
CGCAGCCATGCATCCACTGT	CGCAGCCATGCATCCACTGT	1	0
ACGCATGATTCGGCCTCAAT	ACGCATGATTCGGCCTCAAT	1	0
CTTTCAGAAATAGCAAGTTA	CTTTCAGAAATAGCAAGTTA	1	0
GGAGGACCGTAGCACCCTCG	GGAGGACCGTAGCACCCTCG	1	0
TCCAGGCATTGATGGCCTTC	TCCAGGCATTGATGGCCTTC	1	0
CCACGTGTTTACGTGCCAGT	CCACGTGTTTACGTGCCAGT	1	0
CGGTGCGCAGGTAGCGCGTG	CGGTGCGCAGGTAGCGCGTG	1	0
ACGAAACACCGGACACACAG	ACGAAACACCGGACACACAG	1	0
TTTTTCAGCGTATGATCGGT	TTTTTCAGCGTATGATCGGT	1	0
CTTGACGCACCCCGCTCGCG	CTTGACGCACCCCGCTCGCG	1	0
CGTCACTGTCCAGCCCAGCG	CGTCACTGTCCAGCCCAGCG	1	0
ACTGCACATTGATCCTCGCT	ACTGCACATTGATCCTCGCT	1	0
CACTTGGGTCGCCGAGTTGG	CACTTGGGTCGCCGAGTTGG	1	0
CGATAATACAAATTTTACCG	CGATAATACAAATTTTACCG	1	0
ACCCGATGAGTTTCGTCTCC	ACCCGATGAGTTTCGTCTCC	1	0
CACCTCTCGATATGCATGAT	CACCTCTCGATATGCATGAT	1	0
TCCGGGCGGTCTGCACGTGT	TCCGGGCGGTCTGCACGTGT	1	0
TCTCTCAGTGCCACGACATG	TCTCTCAGTGCCACGACATG	1	0
CCAGCAAGCCCGCAACTTTT	CCAGCAAGCCCGCAACTTTT	1	0
TTACTGTTGCCGCTCTTCCG	TTACTGTTGCCGCTCTTCCG	1	0
ATCCTGAAAATGCTATTTGT	ATCCTGAAAATGCTATTTGT	1	0
TCGTCAGCAACGATCCCTGT	TCGTCAGCAACGATCCCTGT	1	0
TTTTAAGGCAAGCAGAGTGT	TTTTAAGGCAAGCAGAGTGT	1	0
CGAGGGATACTTGTCACCTG	CGAGGGATACTTGTCACCTG	1	0
TCTGGGCATACGGGTGCATT	TCTGGGCATACGGGTGCATT	1	0
TTTTCCACCACTCGAATGCG	TTTTCCACCACTCGAATGCG	1	0
GGAGGGTGAGCCGTTTACTC	GGAGGGTGAGCCGTTTACTC	1	0
CATGTGCTCGCCATCATTCG	CATGTGCTCGCCATCATTCG	1	0
GCGGTAGAAACGTACCTTAT	GCGGTAGAAACGTACCTTAT	1	0
TGGATTGGTCGTTTCATTGT	TGGATTGGTCGTTTCATTGT	1	0
CCACTCGCACATCACCCGTT	CCACTCGCACATCACCCGTT	1	0
CATTACCATAACTGTCCGTT	CATTACCATAACTGTCCGTT	2	0
CTACACTCTCTTGCACGCCG	CTACACTCTCTTGCACGCCG	1	0
CCCATTGATCATACCGTCAG	CCCATTGATCATACCGTCAG	1	0
ATACCACCGACCTAACCGCG	ATACCACCGACCTAACCGCG	1	0
TCTTGTCCGTTATCAACTTG	TCTTGTCCGTTATCAACTTG	1	0
GATCGCAAGATCTGCGCAAT	GATCGCAAGATCTGCGCAAT	1	0
TCACTAGCATGAATCTTGAG	TCACTAGCATGAATCTTGAG	1	0
TTTAGATTTACAGCTAAATG	TTTAGATTTACAGCTAAATG	1	0
GCCAAGCCTACGTCCAAAGT	GCCAAGCCTACGTCCAAAGT	1	0
CGCAGGACAATCCCTCGTCC	CGCAGGACAATCCCTCGTCC	1	0
GAAGACTGTTAGAATGCCTA	GAAGACTGTTAGAATGCCTA	1	0
ACCGTCAACCATGAGAGCTA	ACCGTCAACCATGAGAGCTA	1	0
CCAGCACTCACCATGGCTGG	CCAGCACTCACCATGGCTGG	1	0
CGCAGCCATGCATCCACTCG	CGCAGCCATGCATCCACTCG	1	0
TTACTCAATTAATCGATGTA	TTACTCAATTAATCGATGTA	1	0
GCATGGTTCAGACCTCCCCC	GCATGGTTCAGACCTCCCCC	1	0
CTGCGTCATGCAACCAGCAA	CTGCGTCATGCAACCAGCAA	1	0
GGCTACATCGACTCGTCATG	GGCTACATCGACTCGTCATG	1	0
CCTGCTTCTGACTGTTAGAG	CCTGCTTCTGACTGTTAGAG	1	0
ATACAGTCCCTTTGTATTAG	ATACAGTCCCTTTGTATTAG	1	0
CACCGAGTATGTGGGCCGCC	CACCGAGTATGTGGGCCGCC	4	2
TTTTACAATGGCCACACCAG	TTTTACAATGGCCACACCAG	1	0
GCATTCTCCCACTGATGGTT	GCATTCTCCCACTGATGGTT	1	0
TCAGCAGAAGTCTACGCAGC	TCAGCAGAAGTCTACGCAGC	1	0
GCTTGACATTCTGCTTAGTT	GCTTGACATTCTGCTTAGTT	1	0
CCTCGAGGGATGAGCTCTTC	CCTCGAGGGATGAGCTCTTC	1	0
TCACCCAGTTCAACATCACG	TCACCCAGTTCAACATCACG	1	0
CTTCAAGTTAAAATAAGGCT	CTTCAAGTTAAAATAAGGCT	1	0
TCACTTCATACTGCTTCTCG	TCACTTCATACTGCTTCTCG	1	0
AGTCACCTACCCGCTGGTGC	AGTCACCTACCCGCTGGTGC	1	0
AACTGGGGCTGGCTTGTCAC	AACTGGGGCTGGCTTGTCAC	1	0
TCGATTGTGGCCGCTTCCTG	TCGATTGTGGCCGCTTCCTG	1	0
ACTGGACGTTGTCCACTTGA	ACTGGACGTTGTCCACTTGA	3	0
CGTTCGCCTCGTCTCAGGTA	CGTTCGCCTCGTCTCAGGTA	1	0
TCTGGCTACTCCGTTATCAA	TCTGGCTACTCCGTTATCAA	1	0
TTCCTCTAGTTCACCACCGT	TTCCTCTAGTTCACCACCGT	1	0
GGCCTCGCTCGCATAAGTCC	GGCCTCGCTCGCATAAGTCC	1	0
GACACTCTTGTTCTTGCAAC	GACACTCTTGTTCTTGCAAC	1	0
CCACTCTCTGATAAACTGTT	CCACTCTCTGATAAACTGTT	1	0
TGGGCTGCCGAGCATCTCTT	TGGGCTGCCGAGCATCTCTT	1	0
CGACTGCATATACTATGAAT	CGACTGCATATACTATGAAT	1	0
GGGCACCGTTGTTGCCAGCT	GGGCACCGTTGTTGCCAGCT	2	0
CCAGAGCCATCATGATCTTC	CCAGAGCCATCATGATCTTC	1	0
TATTCCCATCCAACATGTTC	TATTCCCATCCAACATGTTC	1	0
CGATGTCCACGTCTTATTGT	CGATGTCCACGTCTTATTGT	1	0
TAACCAAATTTTTCAACAAT	TAACCAAATTTTTCAACAAT	1	0
AAATGCCGACTTCTATCCGT	AAATGCCGACTTCTATCCGT	1	0
TCTTGTGTTTTAGAGCTAGA	TCTTGTGTTTTAGAGCTAGA	1	0
CGCGGACTCCGTCGCCGTCC	CGCGGACTCCGTCGCCGTCC	1	0
GCCCATCATGTTGAAGTCCG	GCCCATCATGTTGAAGTCCG	1	0
CATCAGCTTATTCCCAATAG	CATCAGCTTATTCCCAATAG	1	0
GTCACCAACTTCCTTTCTTG	GTCACCAACTTCCTTTCTTG	2	0
TGCTTCGAACTTTGTCATCG	TGCTTCGAACTTTGTCATCG	1	0
TTCTGAGCGGATCCCTCGCC	TTCTGAGCGGATCCCTCGCC	1	0
TTCCTCTTCTTCTGCCGTTT	TTCCTCTTCTTCTGCCGTTT	1	0
ACCTGTCGGCCAACCCAAGA	ACCTGTCGGCCAACCCAAGA	1	0
CGTCGTTGTTTGTGTCCCTT	CGTCGTTGTTTGTGTCCCTT	1	0
CTCATCCCCCCGCTTACCGG	CTCATCCCCCCGCTTACCGG	1	0
TTATGCCCTAGCCCCAAGCA	TTATGCCCTAGCCCCAAGCA	1	0
ACCCTTCCAGAACACACGTC	ACCCTTCCAGAACACACGTC	1	0
ATCGTCGTAACCCACAAGCA	ATCGTCGTAACCCACAAGCA	1	0
ATTCCTAGTTATCCGGTGTT	ATTCCTAGTTATCCGGTGTT	1	0
CCCCGACTTACTGGTCGAGG	CCCCGACTTACTGGTCGAGG	1	0
CCAGTTTTTCCTCGTCCTGT	CCAGTTTTTCCTCGTCCTGT	1	0
ACATAACCTCGATGACATAC	ACATAACCTCGATGACATAC	1	0
GGGCCGCCAAGAGATCGTCG	GGGCCGCCAAGAGATCGTCG	1	0
TAGTTATCAGTAGTTTAGAG	TAGTTATCAGTAGTTTAGAG	1	0
TATCTCCATCCAATGCCAGT	TATCTCCATCCAATGCCAGT	1	0
ACTCGGTCATGTGCTCGACG	ACTCGGTCATGTGCTCGACG	1	0
TGAAAGTACTAGAAAAAGTG	TGAAAGTACTAGAAAAAGTG	3	0
TAGAGCTAGAAATAGCAAGT	TAGAGCTAGAAATAGCAAGT	1	0
GAGCCATGGCGGCTGGTTTT	GAGCCATGGCGGCTGGTTTT	1	0
TGCGATCCTCAAGACACTGT	TGCGATCCTCAAGACACTGT	1	0
CGGACTTACCTGGACTGTGC	CGGACTTACCTGGACTGTGC	1	0
ATTTTCATTGACATACCAGT	ATTTTCATTGACATACCAGT	1	0
AGAAGTTCCTGCTGACGCCC	AGAAGTTCCTGCTGACGCCC	1	0
GCGGCACCGCCACAAAGCCC	GCGGCACCGCCACAAAGCCC	1	0
ATCAAAAAATGTACTTACTT	ATCAAAAAATGTACTTACTT	1	0
GCCCCATGTTCAGGGCGCGT	GCCCCATGTTCAGGGCGCGT	1	0
CAAGTGCATTGTTAGCTGAG	CAAGTGCATTGTTAGCTGAG	1	0
TGCTTTGGTACAAGCATCCT	TGCTTTGGTACAAGCATCCT	1	0
TTACCGGTCTTGCGTGCGTG	TTACCGGTCTTGCGTGCGTG	1	0
AAACGCCACCAATTCCAACC	AAACGCCACCAATTCCAACC	1	0
GTGACGAGCCTCTTGAAAAA	GTGACGAGCCTCTTGAAAAA	1	0
GCCCGTCAGCTCAAATCACC	GCCCGTCAGCTCAAATCACC	1	0
CCGCGAGCGACATGGGGGAT	CCGCGAGCGACATGGGGGAT	1	0
CTGTCCATTACGAGTGCCTC	CTGTCCATTACGAGTGCCTC	1	0
CACGATCCCCATCCCCCGCG	CACGATCCCCATCCCCCGCG	1	0
GATGCTCGACCTTGATAGGC	GATGCTCGACCTTGATAGGC	1	0
ACCTGAATGTAGAAAATAAG	ACCTGAATGTAGAAAATAAG	1	0
GCAAGTTAAAATAAGGCTAG	GCAAGTTAAAATAAGGCTAG	2	1
CTCATAGCAGTCCCGAGTAA	CTCATAGCAGTCCCGAGTAA	1	0
GAACTCACCACACCGGACAC	GAACTCACCACACCGGACAC	1	0
TCCATACCATTCCAGCCACG	TCCATACCATTCCAGCCACG	1	0
GTGAGTGCCCGATCCCGCTG	GTGAGTGCCCGATCCCGCTG	1	0
ACTGCACATTCTGAATATTT	ACTGCACATTCTGAATATTT	1	0
GTCGAGGCTGGCCCAGTGCG	GTCGAGGCTGGCCCAGTGCG	1	0
AGCAAGTTAAAATAAGGCTA	AGCAAGTTAAAATAAGGCTA	1	0
TAAGGCTAGTCCGTTATCAA	TAAGGCTAGTCCGTTATCAA	3	1
TGAACATCCATTTGCGCAGT	TGAACATCCATTTGCGCAGT	1	0
CTGCAACTCAAAGCCACGCG	CTGCAACTCAAAGCCACGCG	1	0
GGCCTTGTTCTGCTTGACCC	GGCCTTGTTCTGCTTGACCC	1	0
CCCACCCACCTTAGAGCTAG	CCCACCCACCTTAGAGCTAG	1	0
CTTTCCCTGCTCCTCATCTG	CTTTCCCTGCTCCTCATCTG	1	0
ACATGGAGTCTTGCACGTTT	ACATGGAGTCTTGCACGTTT	1	1
CACATCACCATGCGCCGTGT	CACATCACCATGCGCCGTGT	1	0
TACGCAGCCCGTCCCAAGCG	TACGCAGCCCGTCCCAAGCG	1	0
AGCCTTCAACATGATCACAG	AGCCTTCAACATGATCACAG	1	0
CTCACCGCGAACACTTTCTC	CTCACCGCGAACACTTTCTC	1	0
CCCAGCGTGCAATTCATAGT	CCCAGCGTGCAATTCATAGT	1	0
CGAAACGTCTCCCCGTGGTT	CGAAACGTCTCCCCGTGGTT	2	0
ACTTACTCTTCGATCCCCCG	ACTTACTCTTCGATCCCCCG	1	0
CCACTTCATTTACTGCCTGC	CCACTTCATTTACTGCCTGC	1	0
AGTGTTGTATTCCCAGTAAA	AGTGTTGTATTCCCAGTAAA	1	0
CGATGATTTAGAGCTAGAAA	CGATGATTTAGAGCTAGAAA	1	0
CTGTGCGACTCGCTCAGACC	CTGTGCGACTCGCTCAGACC	1	0
GCAGGTTATAATGCACTTCG	GCAGGTTATAATGCACTTCG	1	0
CATGGCTCCCCGTCGGGGAA	CATGGCTCCCCGTCGGGGAA	3	0
TCCAGCGACAGACCAACACT	TCCAGCGACAGACCAACACT	1	0
CTGCACGTCCTGCCAGCTCC	CTGCACGTCCTGCCAGCTCC	1	0
GTGTCCGAAAGTGTCTCACG	GTGTCCGAAAGTGTCTCACG	1	0
ACAATTGCGCTATGACTCTG	ACAATTGCGCTATGACTCTG	1	0
CCGTCATGCTGTCACCCTTG	CCGTCATGCTGTCACCCTTG	1	0
TCCGCTAGAGACTTGTGTGC	TCCGCTAGAGACTTGTGTGC	1	0
CCCTTCTCGTTGTACCCAGT	CCCTTCTCGTTGTACCCAGT	1	0
ATGCACAAATACACAATGAG	ATGCACAAATACACAATGAG	1	0
AGAATTCTATAGCCACCTCC	AGAATTCTATAGCCACCTCC	1	0
GATGGAGTGCAGACTTACGT	GATGGAGTGCAGACTTACGT	1	0
CTTCAGCCACATCAAATCAG	CTTCAGCCACATCAAATCAG	1	0
TAGGGATGCTTGGAGTTCCG	TAGGGATGCTTGGAGTTCCG	3	0
TTACAACAGGTAACAGCAGA	TTACAACAGGTAACAGCAGA	1	0
TTTATAGAGCACCTCAGCTT	TTTATAGAGCACCTCAGCTT	1	0
CACTAATGCAGGTCCGTTAT	CACTAATGCAGGTCCGTTAT	1	0
CTTGTGAACAGTGCCGTCTG	CTTGTGAACAGTGCCGTCTG	1	0
CTTCAACGGGACCTGGCTAG	CTTCAACGGGACCTGGCTAG	3	0
AGTTAAAATAAGGCTAGTCC	AGTTAAAATAAGGCTAGTCC	1	0
ATGACATCCACAATTTTAAA	ATGACATCCACAATTTTAAA	1	0
GAGCTGAAGTTCAAGTTACA	GAGCTGAAGTTCAAGTTACA	1	0
TCCCTGCGCTGACCGCGTTT	TCCCTGCGCTGACCGCGTTT	1	0
TGTGGCGACATCTCCGCCTT	TGTGGCGACATCTCCGCCTT	1	0
CCGGTATCCATCCTCCGTTA	CCGGTATCCATCCTCCGTTA	1	0
CATATGGAAATAGCAAGTTA	CATATGGAAATAGCAAGTTA	1	0
GCCCGGAGCGCTCGACCACG	GCCCGGAGCGCTCGACCACG	1	0
CTGTAGGATGTTGGGAACGT	CTGTAGGATGTTGGGAACGT	1	0
CACTCACCGTAGCCTTGTAA	CACTCACCGTAGCCTTGTAA	1	0
TTATCAGCTTGAAAAAGTGG	TTATCAGCTTGAAAAAGTGG	2	0
AACTTCGCTAAGCCGTTCCA	AACTTCGCTAAGCCGTTCCA	1	0
CATCCTTCATGTCGCCCGTG	CATCCTTCATGTCGCCCGTG	1	0
TGTCTCCACGATCTCAGCGT	TGTCTCCACGATCTCAGCGT	1	0
TACATATCCCCATGTTTCGT	TACATATCCCCATGTTTCGT	1	0
TCGATTCTGGTCTGGTTGTT	TCGATTCTGGTCTGGTTGTT	1	0
GCGGCTTCTTCTCGCACCCG	GCGGCTTCTTCTCGCACCCG	1	0
CTGCACCGCTCGGGAGGTTT	CTGCACCGCTCGGGAGGTTT	1	0
TCCGGCCCCACACTGACAGC	TCCGGCCCCACACTGACAGC	1	0
CAGCATACTTACTCTCTGCG	CAGCATACTTACTCTCTGCG	1	0
AGACTGATGCTTCGCTTCGT	AGACTGATGCTTCGCTTCGT	1	0
GGTGACGTGTCCTTCGTGAA	GGTGACGTGTCCTTCGTGAA	1	0
GGCTAGCCCGTTATCAACTT	GGCTAGCCCGTTATCAACTT	2	0
GCCCAACCACAGCATCAACA	GCCCAACCACAGCATCAACA	1	0
CCTGTACACCATCCACGTTT	CCTGTACACCATCCACGTTT	1	0
TCCCCCTGGTTTTAGAGCTA	TCCCCCTGGTTTTAGAGCTA	1	0
ACCTCCTCACCTGGGCTTGG	ACCTCCTCACCTGGGCTTGG	1	0
TTCGGTATGACGAGCAAGAT	TTCGGTATGACGAGCAAGAT	1	0
CAGCTATTCCTAGATGACCG	CAGCTATTCCTAGATGACCG	1	0
ATTCTGGCAGCTGTGCCTCG	ATTCTGGCAGCTGTGCCTCG	1	0
TTACCCTGCCCACACTCCTG	TTACCCTGCCCACACTCCTG	2	0
CTACCTTGCTCACAGCCGTT	CTACCTTGCTCACAGCCGTT	1	0
AGCAACTTGCAAAAGTGGCA	AGCAACTTGCAAAAGTGGCA	1	0
TCACCGGGCTAGGAGCATCG	TCACCGGGCTAGGAGCATCG	1	0
TCAACACTGTCACTGTGCCG	TCAACACTGTCACTGTGCCG	1	0
TACCTGCCCGCGGCGACTCG	TACCTGCCCGCGGCGACTCG	1	0
CTGTGTCGCGCTCCTGCAGT	CTGTGTCGCGCTCCTGCAGT	1	0
TCTGTTTCCAAGCCCTAGAA	TCTGTTTCCAAGCCCTAGAA	1	0
CCACCCCCACGATCCACGTT	CCACCCCCACGATCCACGTT	1	0
AACCTCACACAGCTGACTGT	AACCTCACACAGCTGACTGT	1	0
AGACCGCCTAAACCAACTCT	AGACCGCCTAAACCAACTCT	1	0
ACCCAACCGCAGCCTCGCCG	ACCCAACCGCAGCCTCGCCG	1	0
CTCCCTGCAACCCTCCCCGG	CTCCCTGCAACCCTCCCCGG	1	0
TTTTATCTGCCCATCGTTTA	TTTTATCTGCCCATCGTTTA	1	0
CTGCGGGAGCCATTCTGCAT	CTGCGGGAGCCATTCTGCAT	1	0
CCGACTTGACTTGCTCGGTT	CCGACTTGACTTGCTCGGTT	1	0
TAATTGCCTGCTCTCCCCTG	TAATTGCCTGCTCTCCCCTG	1	0
CCGCTGCATATGACCATTCC	CCGCTGCATATGACCATTCC	1	0
CTGATGTCTGTGCTGTCCTA	CTGATGTCTGTGCTGTCCTA	1	0
CTTACTGTTAGATTTATATT	CTTACTGTTAGATTTATATT	1	0
TAGTGCCGAGCTAGAAATAG	TAGTGCCGAGCTAGAAATAG	1	0
GCGAGCTTGGATCTGGACGG	GCGAGCTTGGATCTGGACGG	1	0
TGGACAGCCCAGGAGTCGTT	TGGACAGCCCAGGAGTCGTT	1	0
TCGCGACGTAGTACACGTGA	TCGCGACGTAGTACACGTGA	1	0
GGCCATCGAGCCACGGAGGT	GGCCATCGAGCCACGGAGGT	1	0
CGTCGTCGGCACCTTTGTCG	CGTCGTCGGCACCTTTGTCG	2	0
AGCGTATGAGTTTCACTGCC	AGCGTATGAGTTTCACTGCC	1	0
ACATAGAGCTAGAAATAGCA	ACATAGAGCTAGAAATAGCA	1	0
CCTCTCGCAACCAGTTCGAC	CCTCTCGCAACCAGTTCGAC	1	0
GCCTCACCCATGGCGACGGT	GCCTCACCCATGGCGACGGT	1	0
TTATAAACTTGAAAAAGTGG	TTATAAACTTGAAAAAGTGG	1	0
CTATCGGAGGTGTCATCGGT	CTATCGGAGGTGTCATCGGT	1	0
CACTCCGTGAGACAGGCCTT	CACTCCGTGAGACAGGCCTT	1	0
ACACTGACTACTTACACTTG	ACACTGACTACTTACACTTG	1	0
GCAGACGCAAACTGCCCTGT	GCAGACGCAAACTGCCCTGT	1	0
GATCGTCATTGCTCGGTTTT	GATCGTCATTGCTCGGTTTT	1	0
TCGTGTGACTGGAGCCACGA	TCGTGTGACTGGAGCCACGA	1	0
CCGCCACCCGTCTCATCCAT	CCGCCACCCGTCTCATCCAT	1	0
CTTTGATCAGCAAGTTAAAA	CTTTGATCAGCAAGTTAAAA	2	0
TCGCTACCAACTTGAAAAAG	TCGCTACCAACTTGAAAAAG	1	0
TGTTGAAAGACGAAGCCCGT	TGTTGAAAGACGAAGCCCGT	1	0
TACCAATTGATCTGCCGTTT	TACCAATTGATCTGCCGTTT	1	0
CCTTACCGTCTATCAGGCAC	CCTTACCGTCTATCAGGCAC	1	0
CTGAATGAAGGTGACCTTCA	CTGAATGAAGGTGACCTTCA	1	0
CCTGAGATCAGCTACTGCCG	CCTGAGATCAGCTACTGCCG	1	0
CTCGGATTTGCGCACGAGTG	CTCGGATTTGCGCACGAGTG	1	0
GTAGGCGAAGCTGCTGCTGT	GTAGGCGAAGCTGCTGCTGT	1	0
AAACTGCCCCACTCCTACTG	AAACTGCCCCACTCCTACTG	1	0
TGTCTTTCAGATTCATTTCG	TGTCTTTCAGATTCATTTCG	1	0
TACCTGCTTATAGCAAGTTA	TACCTGCTTATAGCAAGTTA	3	1
GCTGAATCCAAAGCCCGCCC	GCTGAATCCAAAGCCCGCCC	1	0
GGCTTGATTCTCTGAGCTCG	GGCTTGATTCTCTGAGCTCG	1	0
TGACCGAGCTGATGCCTTGA	TGACCGAGCTGATGCCTTGA	1	0
TGTTGCTGACGCAGTCTTCG	TGTTGCTGACGCAGTCTTCG	1	0
TGTACACCCCCCGGACCGTT	TGTACACCCCCCGGACCGTT	1	0
CATTGCTAGGTGAACCTGTT	CATTGCTAGGTGAACCTGTT	1	0
GACTACGTCAAATGCTGCAG	GACTACGTCAAATGCTGCAG	1	0
CTCTGGTCACATTGTTTTTA	CTCTGGTCACATTGTTTTTA	1	0
CCGCTGATGCTCGTAACAAT	CCGCTGATGCTCGTAACAAT	1	0
ATTGAAGCCACCCCAGCATC	ATTGAAGCCACCCCAGCATC	1	0
AGCCATGGCCCCTTCAGAAG	AGCCATGGCCCCTTCAGAAG	1	0
CACAGCGCATCGTGGAGGTT	CACAGCGCATCGTGGAGGTT	1	0
TACCTTGGCATAATCAATTT	TACCTTGGCATAATCAATTT	1	0
GTCGGATACGTCATCACGTT	GTCGGATACGTCATCACGTT	1	0
TCGATGATCCCGCTCCGTTT	TCGATGATCCCGCTCCGTTT	1	0
CTTTCGCCGATAGCAAGTTA	CTTTCGCCGATAGCAAGTTA	1	0
CGAGGCCATCAACGTGTCCG	CGAGGCCATCAACGTGTCCG	2	0
CATCATTCTCGGGCTTGTGA	CATCATTCTCGGGCTTGTGA	1	0
GAGCAAGGTCCGCTATCAAC	GAGCAAGGTCCGCTATCAAC	1	0
CCACATCATCAGACAACATA	CCACATCATCAGACAACATA	1	0
GTACCGAGTTGTGCCCTCGT	GTACCGAGTTGTGCCCTCGT	1	0
AGCGCATTGAGGCAGAATTC	AGCGCATTGAGGCAGAATTC	1	0
CCGTTATCATCAGCCATGCT	CCGTTATCATCAGCCATGCT	1	0
TCTTCACCTACTACACCGCT	TCTTCACCTACTACACCGCT	2	0
TCAGATGAACCTTACCTCCC	TCAGATGAACCTTACCTCCC	1	0
CATCGCACCCGCTGATCTTC	CATCGCACCCGCTGATCTTC	1	0
GATGCTGCAAGTTGCTTAGG	GATGCTGCAAGTTGCTTAGG	1	0
GCCCAACAATGCCGTTACGT	GCCCAACAATGCCGTTACGT	1	1
GCCCATCTGCTGCCTGCGCG	GCCCATCTGCTGCCTGCGCG	1	0
TACAGAGGGAGTCGCCATTG	TACAGAGGGAGTCGCCATTG	1	0
TCACGTTCGATGTCCGAGGT	TCACGTTCGATGTCCGAGGT	1	0
AGCATTATCTGTACATTCAC	AGCATTATCTGTACATTCAC	1	0
AACCTGCAATGATAGAGATT	AACCTGCAATGATAGAGATT	1	0
CAAGATCTAATAGCAAGTTA	CAAGATCTAATAGCAAGTTA	1	0
CAGCTATCATGTCACTAGCT	CAGCTATCATGTCACTAGCT	1	0
TCTGATATCAAAAGATTCGG	TCTGATATCAAAAGATTCGG	1	0
CGTGTGCTCTACGCCACTGT	CGTGTGCTCTACGCCACTGT	1	0
ACCCAGGCCAAATCCTAATT	ACCCAGGCCAAATCCTAATT	1	0
TTTAAGTGGATGCCCCTGAG	TTTAAGTGGATGCCCCTGAG	1	0
GTTGTAGGACAGTCGTGTTG	GTTGTAGGACAGTCGTGTTG	1	0
ACTCCTCCAGCTTCACACGT	ACTCCTCCAGCTTCACACGT	1	0
TTAACTGTTCCAGTGACCCT	TTAACTGTTCCAGTGACCCT	1	0
ACAAGATGCTGATCTTGCTG	ACAAGATGCTGATCTTGCTG	1	0
CCTGTCAACGTGAGCAGCAG	CCTGTCAACGTGAGCAGCAG	1	0
CCCGCACATCTACGCCTCAG	CCCGCACATCTACGCCTCAG	1	0
ACCGTCAGTTCATTATTTCT	ACCGTCAGTTCATTATTTCT	1	0
AACTTGTTACATTACCATCG	AACTTGTTACATTACCATCG	1	0
CGCCCGTGAACCACTTGGTT	CGCCCGTGAACCACTTGGTT	1	0
CACTGTCTTCCGTAATCAAC	CACTGTCTTCCGTAATCAAC	1	0
ACTTGTGAACTGCACACGTT	ACTTGTGAACTGCACACGTT	1	0
AACCAGATTCCACCAGAGTT	AACCAGATTCCACCAGAGTT	1	0
ACAGTGACAGCTCATGACTG	ACAGTGACAGCTCATGACTG	1	0
CATCTCCACTACGATGTGTT	CATCTCCACTACGATGTGTT	1	0
TTGTCCGGTAAACATCTTGT	TTGTCCGGTAAACATCTTGT	1	0
GATTTCAGGTCCCCTGGTTT	GATTTCAGGTCCCCTGGTTT	1	0
TCAGCCTGTCTGCGCTCGCG	TCAGCCTGTCTGCGCTCGCG	1	0
CTCCCCATCTACGTGTCGCG	CTCCCCATCTACGTGTCGCG	1	0
CTACTCCCAGGCTGATTGAG	CTACTCCCAGGCTGATTGAG	1	0
ATCTGCAGCGCCCCACACGG	ATCTGCAGCGCCCCACACGG	1	0
AACCATTTCCATCCTTCTTC	AACCATTTCCATCCTTCTTC	1	0
TGGAAATAGCAAGTTAAAAT	TGGAAATAGCAAGTTAAAAT	1	0
CTTGCAGCATGGCATTACAG	CTTGCAGCATGGCATTACAG	1	0
GTCATCGAACTACTCTTAGC	GTCATCGAACTACTCTTAGC	1	0
CTACCTTACCACGAGCAGTA	CTACCTTACCACGAGCAGTA	1	0
ACCGGTCCCATCTCCACACG	ACCGGTCCCATCTCCACACG	1	0
TGAGGTGCTTTTTTGAATTC	TGAGGTGCTTTTTTGAATTC	1	0
TACTCACCGATGACCTGTTT	TACTCACCGATGACCTGTTT	1	0
GGCTAAACTCATCCATTCTG	GGCTAAACTCATCCATTCTG	1	0
GACTTTTTCATCGTCATCGC	GACTTTTTCATCGTCATCGC	1	0
ACAGATCCTCTTCCGCCGCG	ACAGATCCTCTTCCGCCGCG	1	0
TTCTTTAGGAGCTTTTGGTT	TTCTTTAGGAGCTTTTGGTT	1	0
TAGGACAGCCGCATGCTTCG	TAGGACAGCCGCATGCTTCG	1	0
TTCCTGTTACCAGTTTTAGA	TTCCTGTTACCAGTTTTAGA	1	0
CGACCAGCCCTTCATCCGCG	CGACCAGCCCTTCATCCGCG	1	0
GAAAGGAAGTCTCGCCGAGG	GAAAGGAAGTCTCGCCGAGG	1	0
TTGCATAGAGCTAGAAATAG	TTGCATAGAGCTAGAAATAG	1	0
CAGGGGGCAGCACGGTGATC	CAGGGGGCAGCACGGTGATC	1	0
CACCACGTCACCATAACCGA	CACCACGTCACCATAACCGA	1	0
CCGACCGAAGCTGAATGTGG	CCGACCGAAGCTGAATGTGG	1	0
AACCACCTCTACCTGTATCG	AACCACCTCTACCTGTATCG	1	0
ACCAACTCAACTGTGAAGGT	ACCAACTCAACTGTGAAGGT	1	0
TAAGCACTTCTGCAACCTGT	TAAGCACTTCTGCAACCTGT	1	0
TCTGGGGACAGCTGGAGTCG	TCTGGGGACAGCTGGAGTCG	1	0
TTATCAACTTGAAAAAGTGG	TTATCAACTTGAAAAAGTGG	3	9
TGAGAGAAATCCTCCTTTAG	TGAGAGAAATCCTCCTTTAG	1	0
CGTCTATGATGACCTGCCCG	CGTCTATGATGACCTGCCCG	1	0
CCCAACAATACCACCGACCG	CCCAACAATACCACCGACCG	1	0
CACCCGTTTCCATGTCAACA	CACCCGTTTCCATGTCAACA	1	0
TATATTGCTCAAGTGACATA	TATATTGCTCAAGTGACATA	1	0
GCTAGTGTCCGGGATCTACT	GCTAGTGTCCGGGATCTACT	2	0
GACGGACGAGCGTCTGTAAC	GACGGACGAGCGTCTGTAAC	1	0
TCAGCAAGTTAAAATAAGGC	TCAGCAAGTTAAAATAAGGC	1	0
GAGGAGATGCTGTTCAACTA	GAGGAGATGCTGTTCAACTA	1	0
TCCCGTGAAACGAACTACAG	TCCCGTGAAACGAACTACAG	1	0
GCCCCAAGCTGTGTCCAATC	GCCCCAAGCTGTGTCCAATC	1	0
TAATACATACTGCACCATTG	TAATACATACTGCACCATTG	1	0
TTTCTGACAGGTGTTCACAG	TTTCTGACAGGTGTTCACAG	1	0
TGCTGTTTCAGACCTGACGT	TGCTGTTTCAGACCTGACGT	1	0
TGCGATCTCTGTGTTGGAAC	TGCGATCTCTGTGTTGGAAC	1	0
AGCCCACATGCTATCCACAG	AGCCCACATGCTATCCACAG	1	0
AACGCATCGTCACTGCATCT	AACGCATCGTCACTGCATCT	1	0
ACTCGCACAGCGCGTCAGAC	ACTCGCACAGCGCGTCAGAC	1	0
ACATGTCCCCGTGCCTCACG	ACATGTCCCCGTGCCTCACG	1	0
CCTTCTCGAAGTTGCCGTTT	CCTTCTCGAAGTTGCCGTTT	1	0
GCTCTCTGCAGCGCGGCGCG	GCTCTCTGCAGCGCGGCGCG	1	0
CGATCCTGTTATCAACTTGA	CGATCCTGTTATCAACTTGA	1	0
TTGGGCTGACCTGCGCCCTG	TTGGGCTGACCTGCGCCCTG	1	0
TGTCGCAGTTCGTGGGCCCT	TGTCGCAGTTCGTGGGCCCT	1	0
CACTCCCAGCATGAGTTTTA	CACTCCCAGCATGAGTTTTA	1	0
GGAGCTCTACAGAATAGAGC	GGAGCTCTACAGAATAGAGC	1	0
TCCGAGCTTCCAGCCGCTCC	TCCGAGCTTCCAGCCGCTCC	1	0
CACGTTTCAAAGTTCAAAGG	CACGTTTCAAAGTTCAAAGG	1	0
TGCTGCATGTCTGTGCCAGG	TGCTGCATGTCTGTGCCAGG	1	0
CCCGCTTCCATGAATCCGTT	CCCGCTTCCATGAATCCGTT	2	0
GGACTGTTCAGTTGATGTGC	GGACTGTTCAGTTGATGTGC	1	0
CAGCTCGGCCTCACCATCAG	CAGCTCGGCCTCACCATCAG	1	0
AGCTGGTGTACCTTGATGTT	AGCTGGTGTACCTTGATGTT	1	0
GGCAGACATCCCACTACGTT	GGCAGACATCCCACTACGTT	1	0
ACTGGTGCCAAACTCCTCGT	ACTGGTGCCAAACTCCTCGT	1	0
CGAGAAGCTCTGCTGAGTGC	CGAGAAGCTCTGCTGAGTGC	1	0
CCGTCCGTCCTCGTTCTTTA	CCGTCCGTCCTCGTTCTTTA	1	0
ACCCGATGAGTTGCGTCCCC	ACCCGATGAGTTGCGTCCCC	1	0
AATCCAACCAGCTAGAAATA	AATCCAACCAGCTAGAAATA	1	0
AACTCTCCCACCATTACATC	AACTCTCCCACCATTACATC	1	0
AGTGCTGAGTTCATTGCAGG	AGTGCTGAGTTCATTGCAGG	1	0
CTGCGCCTTTGTCATCGCCT	CTGCGCCTTTGTCATCGCCT	1	0
TGTCATCATGATGTCCTTTC	TGTCATCATGATGTCCTTTC	1	0
ACCCGCCTAACTTGAGCACT	ACCCGCCTAACTTGAGCACT	1	0
TCCATAGTAGGCTAGTCCGT	TCCATAGTAGGCTAGTCCGT	1	0
CGAATCAAATCCCGTTTGTG	CGAATCAAATCCCGTTTGTG	1	0
TGTTTGCAACATCTATGCCG	TGTTTGCAACATCTATGCCG	1	0
TCATGTACGCCTAAGAAAGT	TCATGTACGCCTAAGAAAGT	1	0
CACAGTTACATCGTGCGCCG	CACAGTTACATCGTGCGCCG	1	0
TTACACGCTCTTGCGTTTTG	TTACACGCTCTTGCGTTTTG	1	0
AGCAGTGAAACACATGTTTG	AGCAGTGAAACACATGTTTG	1	0
TAGTGCATCTGGAAGCTTGT	TAGTGCATCTGGAAGCTTGT	1	0
CGCGTTTTAGTCTCAGCTCC	CGCGTTTTAGTCTCAGCTCC	1	0
GTCCTGCTCACCCACATCGT	GTCCTGCTCACCCACATCGT	1	0
AGATTACCTGAAGCTTCTTC	AGATTACCTGAAGCTTCTTC	1	0
AGCACTCACAGAGGGGGTTG	AGCACTCACAGAGGGGGTTG	1	0
CAACGTCTATAGCCAGCTGG	CAACGTCTATAGCCAGCTGG	1	0
TTCACGACGTCCTGTATGTG	TTCACGACGTCCTGTATGTG	1	0
CTTTGTGACCCTGCAATCGT	CTTTGTGACCCTGCAATCGT	1	0
TTCATAATCAGGCGCTGCGT	TTCATAATCAGGCGCTGCGT	1	0
TCCCTTATTATGCTGCTTCG	TCCCTTATTATGCTGCTTCG	1	0
GTTGAGGTTGTCCAATCCGT	GTTGAGGTTGTCCAATCCGT	1	0
TGACTTAGAGCTAGAAATAG	TGACTTAGAGCTAGAAATAG	1	0
AGCCTAGTCCGTTATCAACT	AGCCTAGTCCGTTATCAACT	1	0
CCAATACTTTACACCTCCAG	CCAATACTTTACACCTCCAG	1	0
CAGGAACTGTGTGCCTACGG	CAGGAACTGTGTGCCTACGG	1	0
GACTGCGTGGCTCTACCCGT	GACTGCGTGGCTCTACCCGT	1	0
GGCAATAGCAAGCTAAAATA	GGCAATAGCAAGCTAAAATA	1	0
TGAGTGGCTACCAGCCAAGG	TGAGTGGCTACCAGCCAAGG	1	0
ATAGTCTAGATGTGCTTCAC	ATAGTCTAGATGTGCTTCAC	1	0
CTGCAAGCCCTGCTGTTCCC	CTGCAAGCCCTGCTGTTCCC	1	0
CAGGAGCACTCATTTGAGAT	CAGGAGCACTCATTTGAGAT	1	0
GCTGCTAGAACACCATTTAC	GCTGCTAGAACACCATTTAC	1	0
GCCGACATGCGCCCGCTTCG	GCCGACATGCGCCCGCTTCG	1	0
GAGCGTGGCTGACATACGGT	GAGCGTGGCTGACATACGGT	1	0
CGGAAGAACCACTGACTGTG	CGGAAGAACCACTGACTGTG	1	0
TGCTAAGTTCTGAGAGTTCA	TGCTAAGTTCTGAGAGTTCA	1	0
GGGCACCTCAATCTTCGTTT	GGGCACCTCAATCTTCGTTT	1	0
CGAACCTCTGAAGGTGCCGT	CGAACCTCTGAAGGTGCCGT	1	0
CAGCCCTCCACCGCTGTCGC	CAGCCCTCCACCGCTGTCGC	1	0
TTTATGCCTGGCACCTACTG	TTTATGCCTGGCACCTACTG	1	0
CTCATTATAGCTGCGACTCA	CTCATTATAGCTGCGACTCA	1	0
AGTCGGAAGCCCCTGGCAGT	AGTCGGAAGCCCCTGGCAGT	1	0
TCCTTTAAATAGCAAGTTAA	TCCTTTAAATAGCAAGTTAA	2	0
GCCTTCAAGAGCTCCCTTTA	GCCTTCAAGAGCTCCCTTTA	1	0
CGAGCAAGCTAAAATAAGGC	CGAGCAAGCTAAAATAAGGC	2	0
CGTGCTTCTAGGTTCCCTGT	CGTGCTTCTAGGTTCCCTGT	1	0
CAGAGTTTGAAGCCACGTCG	CAGAGTTTGAAGCCACGTCG	1	0
CTGACAGTGATTGACACACG	CTGACAGTGATTGACACACG	1	0
TACAGTCACATCTTGTTCGT	TACAGTCACATCTTGTTCGT	1	0
AGTTACTTTCTGAGCAGCAG	AGTTACTTTCTGAGCAGCAG	1	0
TTACTGTGTTTTAGAGCTAG	TTACTGTGTTTTAGAGCTAG	1	0
ACCTATTGCATCATTCCTGG	ACCTATTGCATCATTCCTGG	1	0
CTTCCTCACTAGAAATAGCA	CTTCCTCACTAGAAATAGCA	1	0
AGCGTGTCTAGGGCACCGCG	AGCGTGTCTAGGGCACCGCG	1	0
CATGAGCACGAAGCTGCTGT	CATGAGCACGAAGCTGCTGT	1	0
TGAGCAGCACTCGACCCACG	TGAGCAGCACTCGACCCACG	1	0
CAGTCCAAATGGCTCCCTTG	CAGTCCAAATGGCTCCCTTG	1	0
ATGCAGGCTACAGTAGATGC	ATGCAGGCTACAGTAGATGC	1	0
ACAGGGGTAGTTCATTCAGT	ACAGGGGTAGTTCATTCAGT	1	0
TTGTGTAGCTCTGTGCTTGG	TTGTGTAGCTCTGTGCTTGG	1	0
GGTCAGCCCGTTATCAACTT	GGTCAGCCCGTTATCAACTT	1	0
CTCGGTGCCTACTTCGTCGA	CTCGGTGCCTACTTCGTCGA	1	0
TTAATCAAACTTGAAAAAGT	TTAATCAAACTTGAAAAAGT	1	0
AGCGACCGTCTGTGGTGTTT	AGCGACCGTCTGTGGTGTTT	1	0
TTAGAGAAGATCCATCATTT	TTAGAGAAGATCCATCATTT	1	0
ATTTCGTCGTAAAATTGCCG	ATTTCGTCGTAAAATTGCCG	1	0
TTCAGATGATACAAAAAAAT	TTCAGATGATACAAAAAAAT	1	0
CCACATGGGGAAAGAATTCA	CCACATGGGGAAAGAATTCA	1	0
TCAATCAAGTTAAAACAAGG	TCAATCAAGTTAAAACAAGG	1	0
ATTTTCCAAGCCTACCCATG	ATTTTCCAAGCCTACCCATG	1	0
TTTACAACCCTTCAGACCTG	TTTACAACCCTTCAGACCTG	1	0
GATTACGTATTCCTGCAACG	GATTACGTATTCCTGCAACG	1	0
AATATTAAACAAATCTGGGG	AATATTAAACAAATCTGGGG	1	0
CTGAGGGTAGCAAGTTAAAA	CTGAGGGTAGCAAGTTAAAA	1	0
TGTCTAGTCGCTGTCTGAGG	TGTCTAGTCGCTGTCTGAGG	1	0
CTTACAGCCCAAATTGGTTT	CTTACAGCCCAAATTGGTTT	1	0
ATCATCTTACCAGCTACAAA	ATCATCTTACCAGCTACAAA	1	0
ACGTCCTCGGGCCCTGCGCG	ACGTCCTCGGGCCCTGCGCG	1	0
AACGCCAAGCTTACCATGCG	AACGCCAAGCTTACCATGCG	1	0
CTCACCGAAATAGCAAGTTA	CTCACCGAAATAGCAAGTTA	1	0
CCCGAACCTGTAGGCACTCG	CCCGAACCTGTAGGCACTCG	1	0
ACACGGCACATGGCATCCGG	ACACGGCACATGGCATCCGG	1	1
ACGTAGCATAGGCTGATTGG	ACGTAGCATAGGCTGATTGG	1	0
TCCGTTGGTCGATTCACAGT	TCCGTTGGTCGATTCACAGT	1	0
TGCTTTCTGCTGACTCTTGT	TGCTTTCTGCTGACTCTTGT	1	0
CATTCCACCACCCAATGTAG	CATTCCACCACCCAATGTAG	1	0
CACGCCGACACGTCCCGCGT	CACGCCGACACGTCCCGCGT	1	0
TAGCAATAGGAACAGAGATC	TAGCAATAGGAACAGAGATC	1	0
TGAAAGTACTAGAAAAAGGG	TGAAAGTACTAGAAAAAGGG	1	0
TTGACAGTCCCAATCACTTG	TTGACAGTCCCAATCACTTG	1	1
CCCCAGTTAAAATAAGGCTA	CCCCAGTTAAAATAAGGCTA	1	0
TTTACCTGTGACAGCAACTG	TTTACCTGTGACAGCAACTG	1	0
AGCCATCACTGCTATCATCC	AGCCATCACTGCTATCATCC	1	0
GGAACTGACTTCTCAGAGCG	GGAACTGACTTCTCAGAGCG	1	0
ATGAACAAGCATCTACTGCC	ATGAACAAGCATCTACTGCC	1	0
TTACATGGGTTCCCCATCTT	TTACATGGGTTCCCCATCTT	1	0
TCACATCGAGGGTCTGCACG	TCACATCGAGGGTCTGCACG	1	0
GGGCTAGAATTAGCAAGTTA	GGGCTAGAATTAGCAAGTTA	1	0
GCAGTACGTCCGAGCTCCCG	GCAGTACGTCCGAGCTCCCG	1	1
TGAGCACGATGAAACAGACT	TGAGCACGATGAAACAGACT	1	0
CGAGATGGAGAAGAGTAATT	CGAGATGGAGAAGAGTAATT	1	0
TTAGCAGTAGAGCTAGAAAT	TTAGCAGTAGAGCTAGAAAT	1	0
TTACACCAAAGGCCACTGGA	TTACACCAAAGGCCACTGGA	1	0
GATCGGGAGGGTCCTCCCCG	GATCGGGAGGGTCCTCCCCG	1	0
ACTCAGTCCACCAATAGTGG	ACTCAGTCCACCAATAGTGG	1	0
TGTCCTACCTCTACATCTTC	TGTCCTACCTCTACATCTTC	1	0
AATCCCGTTATCGCAACCAG	AATCCCGTTATCGCAACCAG	1	0
CCCTGACACAGCCTCGACGT	CCCTGACACAGCCTCGACGT	1	0
CAACTCCTTCTACTACCCGG	CAACTCCTTCTACTACCCGG	1	0
AAACTTAGGGCCACTGATTG	AAACTTAGGGCCACTGATTG	1	0
CATCGATGTCCACCAACATC	CATCGATGTCCACCAACATC	1	0
CAGCCAAAGACATCCCATTC	CAGCCAAAGACATCCCATTC	1	0
CCTCCAGTGCAGCCATCATC	CCTCCAGTGCAGCCATCATC	1	0
TATCCGACCACTTCCTCCCG	TATCCGACCACTTCCTCCCG	1	0
AGGCAAATGGCAGTATTCAT	AGGCAAATGGCAGTATTCAT	1	0
TTGTGCCCCGAAATAGCAAG	TTGTGCCCCGAAATAGCAAG	1	0
TTGTTATTTGACACTATTTA	TTGTTATTTGACACTATTTA	1	0
CTGCTTCTTATCAGCTTGAA	CTGCTTCTTATCAGCTTGAA	1	0
GAATCCAAGTCACACGAGTT	GAATCCAAGTCACACGAGTT	1	0
TTCTGTCTCCTGATCATCGT	TTCTGTCTCCTGATCATCGT	1	0
GACAACTCAAACTCCGACGT	GACAACTCAAACTCCGACGT	1	0
TCACCCTGCCCACACTCCCT	TCACCCTGCCCACACTCCCT	1	0
AGATCACTTACCTCCCCGCT	AGATCACTTACCTCCCCGCT	1	0
TGTCTACACTATCATGTTTC	TGTCTACACTATCATGTTTC	1	0
TCTTGTATCCTTAGCTGTTT	TCTTGTATCCTTAGCTGTTT	2	0
TACTAATAGCAAGTTAAAAT	TACTAATAGCAAGTTAAAAT	1	0
GATGCAATGACGATCCCCAG	GATGCAATGACGATCCCCAG	1	0
CCTCCAACTAGCGGCAGTCC	CCTCCAACTAGCGGCAGTCC	1	0
TGACTTCTGCCTTTGTTTTA	TGACTTCTGCCTTTGTTTTA	1	0
CCTCGAGTCATCGTCATCGT	CCTCGAGTCATCGTCATCGT	1	0
GCACTGATCCTAGACCCATT	GCACTGATCCTAGACCCATT	1	0
CAATCTTGCCTCTAGTTCCG	CAATCTTGCCTCTAGTTCCG	1	0
GGAGTTATCAACTTGAAAAA	GGAGTTATCAACTTGAAAAA	1	0
CTGTTTTAGGGCTAGAAATA	CTGTTTTAGGGCTAGAAATA	1	0
CGCATCGCAGCATCGACAGT	CGCATCGCAGCATCGACAGT	1	0
ATCCACTTCGTGTCTTATGT	ATCCACTTCGTGTCTTATGT	1	0
TCCACGATGTACTCGTCCCG	TCCACGATGTACTCGTCCCG	1	0
ACCTTGAGTCCTCTATAGCG	ACCTTGAGTCCTCTATAGCG	1	0
TGTGGTGGGCATCTGTTCAG	TGTGGTGGGCATCTGTTCAG	1	0
CACACTAGACGCCAGATGCG	CACACTAGACGCCAGATGCG	1	0
CCCGTACCTGTCCGACACGT	CCCGTACCTGTCCGACACGT	1	0
TCGTGTCGGAAGTGTCTCAG	TCGTGTCGGAAGTGTCTCAG	1	0
TTCAAGCAGGTTAAAATAAG	TTCAAGCAGGTTAAAATAAG	1	0
ACATGTCGTTTTAGAGCTAG	ACATGTCGTTTTAGAGCTAG	1	0
TTTACCCGCCGAAGCCATAG	TTTACCCGCCGAAGCCATAG	1	0
ACAAGCGTCCTCAACCAGCA	ACAAGCGTCCTCAACCAGCA	1	0
ACATGGTCAATATGAAAGCG	ACATGGTCAATATGAAAGCG	1	0
GGCTCCACATAAGATGTATT	GGCTCCACATAAGATGTATT	1	0
TAAGTTCTTCTTGTCCTCGT	TAAGTTCTTCTTGTCCTCGT	1	0
CGCCCCGACAGTTTTAGAGC	CGCCCCGACAGTTTTAGAGC	1	0
CCTCTTCTGCCTACAGTACC	CCTCTTCTGCCTACAGTACC	1	0
GCCACCTTTGGGTCCGCTTT	GCCACCTTTGGGTCCGCTTT	1	0
TCAGGCTAAAACTCCAGTTT	TCAGGCTAAAACTCCAGTTT	1	0
TTCAACCCTCACTTCGATTG	TTCAACCCTCACTTCGATTG	1	0
ACCACTGTGCCATCATTCCG	ACCACTGTGCCATCATTCCG	1	0
AACACTGCCCGTCTAACTTG	AACACTGCCCGTCTAACTTG	1	0
AATCACTGCCTGAAGACGGT	AATCACTGCCTGAAGACGGT	1	0
TCGAATCTGCCATGCGAACG	TCGAATCTGCCATGCGAACG	1	0
GCCCACCCACCTCGTTATTT	GCCCACCCACCTCGTTATTT	1	0
CAGTGGCCGTCACGGTCAGC	CAGTGGCCGTCACGGTCAGC	1	0
TTGAAGACCGAATGATCTGT	TTGAAGACCGAATGATCTGT	1	0
GTCAAAGTACGAGTCTATGT	GTCAAAGTACGAGTCTATGT	1	0
TTTGTGTGTTCATTGAAGAA	TTTGTGTGTTCATTGAAGAA	1	0
AGACCTACAAATTCCGCACT	AGACCTACAAATTCCGCACT	1	0
AGTTATAATAAGGCTAGTCC	AGTTATAATAAGGCTAGTCC	1	0
AGCTGACGCCGACCTTCGCG	AGCTGACGCCGACCTTCGCG	1	0
GTGTTAAGCCCTCCTCATGT	GTGTTAAGCCCTCCTCATGT	1	0
TTACTGTTGCCCGTTTTAGA	TTACTGTTGCCCGTTTTAGA	1	0
CATTCAACAGCTCCTCTGCC	CATTCAACAGCTCCTCTGCC	1	0
GTAGTAGCTGTCCAGTCCGT	GTAGTAGCTGTCCAGTCCGT	3	3
GTCGCCGATCACGAAGTAGA	GTCGCCGATCACGAAGTAGA	1	0
CGTGTCCAGTCCCGAAGTGA	CGTGTCCAGTCCCGAAGTGA	1	0
ATGGAGAAGACAGTTTTAGA	ATGGAGAAGACAGTTTTAGA	1	0
TACATCAACCCGCCGTCACT	TACATCAACCCGCCGTCACT	1	0
GGACCGAGCCAATGAGCTCG	GGACCGAGCCAATGAGCTCG	1	0
CACTCACCATGATCCTCGTA	CACTCACCATGATCCTCGTA	1	0
TTGGCAGAGAATCCAAGTCG	TTGGCAGAGAATCCAAGTCG	1	0
CTTTGAGACATGCGTTTTAG	CTTTGAGACATGCGTTTTAG	1	0
TTTAGAGCTAGAAATAGCAA	TTTAGAGCTAGAAATAGCAA	1	0
TTCTACCAGCAATCTCCATG	TTCTACCAGCAATCTCCATG	1	0
CTGCTCCACCGTCATGCGCC	CTGCTCCACCGTCATGCGCC	1	0
CTAGGCCATGTAGCCCCTGT	CTAGGCCATGTAGCCCCTGT	1	0
ATGCAACGACGTATTCCACG	ATGCAACGACGTATTCCACG	1	0
TAGTTCTCAAACCAAGTTAA	TAGTTCTCAAACCAAGTTAA	1	0
CAGCCACTTACCTGAGCCCG	CAGCCACTTACCTGAGCCCG	1	0
TCAGTGGAGTGAGCTGACCC	TCAGTGGAGTGAGCTGACCC	1	0
TCCATTTAAATAGCAAGTTA	TCCATTTAAATAGCAAGTTA	1	0
CACCCTATTTCCGTGTATAT	CACCCTATTTCCGTGTATAT	1	0
TGGCAGGCGCGGCGAGTCCC	TGGCAGGCGCGGCGAGTCCC	1	0
TTATTCTCCAGGCACCTACG	TTATTCTCCAGGCACCTACG	1	0
CATGCCATCATCTTCCGAGT	CATGCCATCATCTTCCGAGT	1	0
CCACCCAACTAAACCACTTT	CCACCCAACTAAACCACTTT	1	0
TTCATGACTCCACTAAAAGT	TTCATGACTCCACTAAAAGT	1	0
GCTCTTCTACTTCGTCAAGT	GCTCTTCTACTTCGTCAAGT	1	0
CGCAGTCATCATCAACTGCC	CGCAGTCATCATCAACTGCC	1	0
CCTCTGTGTTGACACTAGTG	CCTCTGTGTTGACACTAGTG	1	0
TCCCGTCCTGCTAAGAGTGT	TCCCGTCCTGCTAAGAGTGT	1	0
CGGAGATGTCGTTGTTCTGT	CGGAGATGTCGTTGTTCTGT	1	0
CGCTGGACTCGTCCTCAGGT	CGCTGGACTCGTCCTCAGGT	1	0
CAATTAGGGCATGGACCGTT	CAATTAGGGCATGGACCGTT	1	0
TTTTACGTTGACCAGTGATT	TTTTACGTTGACCAGTGATT	1	0
TCTCATAATCTCCTTGTATG	TCTCATAATCTCCTTGTATG	1	0
TTGTGAACTTTGTCCCCATA	TTGTGAACTTTGTCCCCATA	1	0
GGTGACCATCTACCACCTTG	GGTGACCATCTACCACCTTG	1	0
CGACTTTTCCTACTTGTATT	CGACTTTTCCTACTTGTATT	1	0
TGTCAACTTGATCAGTCTGG	TGTCAACTTGATCAGTCTGG	1	0
ACTTACCATCCTGTCAGAGG	ACTTACCATCCTGTCAGAGG	1	1
ATACTGTGAACAAGGACTTT	ATACTGTGAACAAGGACTTT	1	0
CCCACAACTTCATGCTGCGT	CCCACAACTTCATGCTGCGT	1	0
TACGACTACTCGGAGCCCGT	TACGACTACTCGGAGCCCGT	1	0
GGACTGCCCCCTCACCTATT	GGACTGCCCCCTCACCTATT	1	0
TCCGCGCCTCGTTCACTCTT	TCCGCGCCTCGTTCACTCTT	1	0
CGAGACCATCAACGTGGACC	CGAGACCATCAACGTGGACC	1	0
TGCCGCGCGCGCAATGCATG	TGCCGCGCGCGCAATGCATG	1	0
GCCCCACCTGACATCCGCGG	GCCCCACCTGACATCCGCGG	1	0
GTAGAAGGATCACCACCTTC	GTAGAAGGATCACCACCTTC	1	0
CTCTGCTGTCCCGCTTTGTT	CTCTGCTGTCCCGCTTTGTT	1	0
TTGAATCGGGTACGGAGCTC	TTGAATCGGGTACGGAGCTC	1	0
CAACGCAAGTTAAAATAAGG	CAACGCAAGTTAAAATAAGG	1	0
CGTCCTACTCGACCAGGTTT	CGTCCTACTCGACCAGGTTT	1	0
GTCATTCTGACAAATCACGA	GTCATTCTGACAAATCACGA	1	0
TACCAGAAGACGTCCCATCA	TACCAGAAGACGTCCCATCA	1	0
TGCGATCTGCCCCGCGTGGT	TGCGATCTGCCCCGCGTGGT	1	0
CTCGAGCAGAGCGCAATCGT	CTCGAGCAGAGCGCAATCGT	1	0
GCAAAGCGGCCATGCGTTCT	GCAAAGCGGCCATGCGTTCT	1	0
TTGACACAAAGCCAGTACCG	TTGACACAAAGCCAGTACCG	1	0
TAGCACCAGTAGGCCGTTAT	TAGCACCAGTAGGCCGTTAT	1	0
TTCCACATCGATCACGTCTG	TTCCACATCGATCACGTCTG	1	0
CTTACCTTCATTCGGGACAG	CTTACCTTCATTCGGGACAG	1	0
TGGCATATTTTAAATGGCCG	TGGCATATTTTAAATGGCCG	1	0
CCAAGTACCGCTGGGTCGGG	CCAAGTACCGCTGGGTCGGG	1	0
AGTCCTCTGTAACACTGTCG	AGTCCTCTGTAACACTGTCG	1	0
CGACACCAACATCGCTGACC	CGACACCAACATCGCTGACC	1	0
TTGCAGTCTCGAAAATAGCA	TTGCAGTCTCGAAAATAGCA	1	0
CCACCCATGGGCACGCAGTT	CCACCCATGGGCACGCAGTT	1	0
TACCAGACTGCTTGTTTCGT	TACCAGACTGCTTGTTTCGT	1	0
CCTCCAGTCCCATGATGCAG	CCTCCAGTCCCATGATGCAG	1	0
TACCTCATCCGACACCCGTT	TACCTCATCCGACACCCGTT	1	0
CAGGGGGTAGCACGGAGATC	CAGGGGGTAGCACGGAGATC	1	1
TTAACCAGCCCCTTCAGTTT	TTAACCAGCCCCTTCAGTTT	1	0
GTGCGGCATCAACTATGATT	GTGCGGCATCAACTATGATT	1	0
CTCGATGTCGATGCTCCGCG	CTCGATGTCGATGCTCCGCG	1	0
GCGACCCCTTATGAAGCTGT	GCGACCCCTTATGAAGCTGT	1	0
CACGGAGTCTTCTTCGTAGT	CACGGAGTCTTCTTCGTAGT	1	0
CACCATCTCACACGTTTTAG	CACCATCTCACACGTTTTAG	1	0
TACTGTGTTACACTATAGTT	TACTGTGTTACACTATAGTT	1	0
TTCCTGCTTACAGCCTCAGT	TTCCTGCTTACAGCCTCAGT	1	0
GTATGAACTAGTGCACACGT	GTATGAACTAGTGCACACGT	1	0
GCGCCCACCGACTACGTCAA	GCGCCCACCGACTACGTCAA	1	0
TCAGTTGCTATGTCCCCACG	TCAGTTGCTATGTCCCCACG	1	0
AGATGGCTTGCGCTGACACT	AGATGGCTTGCGCTGACACT	1	0
GTAGCCTCGATGACGGCGGT	GTAGCCTCGATGACGGCGGT	1	0
GCCCTATTCGAATGCAACGG	GCCCTATTCGAATGCAACGG	1	0
GGCCACGTTATCCACTTGAA	GGCCACGTTATCCACTTGAA	1	1
GGGAATTGTGGTTTTCTCTT	GGGAATTGTGGTTTTCTCTT	1	0
CGCTGCCATCACCTTGAAAA	CGCTGCCATCACCTTGAAAA	1	0
CTTGCACTACCAAGTCATCA	CTTGCACTACCAAGTCATCA	1	0
TGCATGGTCCGTTATCAACT	TGCATGGTCCGTTATCAACT	1	0
TTTCACAGGCGTCGGCATTC	TTTCACAGGCGTCGGCATTC	1	0
CACTTAGAGCTAGAAATAGC	CACTTAGAGCTAGAAATAGC	1	0
AGGACGCAGCTGCCTGCCCG	AGGACGCAGCTGCCTGCCCG	1	0
CTTGCTGCCCCCCTGCCCGT	CTTGCTGCCCCCCTGCCCGT	1	0
ACACCGATACGTGACACTAG	ACACCGATACGTGACACTAG	1	0
CTCCCGTTCGCGTCGCCGAG	CTCCCGTTCGCGTCGCCGAG	1	0
GCAGTTCCCTGACAGCTATG	GCAGTTCCCTGACAGCTATG	1	0
CCTGAATTTTCTTGACACGG	CCTGAATTTTCTTGACACGG	1	0
GCCCGAAGTTTTAGAGCTAG	GCCCGAAGTTTTAGAGCTAG	1	0
TCCAGTGCCCGAACTGCACT	TCCAGTGCCCGAACTGCACT	1	0
CTGGTCTCCCTGCACTGTTT	CTGGTCTCCCTGCACTGTTT	1	0
ACACAAGCATCCACGTCCGG	ACACAAGCATCCACGTCCGG	1	0
GCCGGGACTTGTCACTATGT	GCCGGGACTTGTCACTATGT	1	0
CTAGCCAAACATCATGTTAA	CTAGCCAAACATCATGTTAA	1	0
GTATGGCAAATAAGAACACG	GTATGGCAAATAAGAACACG	1	0
ATCCTACCGACCTGCCCACT	ATCCTACCGACCTGCCCACT	1	0
CGATGCGTTACCTTCCTTAG	CGATGCGTTACCTTCCTTAG	1	0
CTTCCTCCTCATCTCATCTG	CTTCCTCCTCATCTCATCTG	1	0
CGGTTGCAAAACTTTCAGAG	CGGTTGCAAAACTTTCAGAG	1	0
TTTCCTGGGAGAGTACCTTC	TTTCCTGGGAGAGTACCTTC	1	0
TTCAACGCCCCTTTGATGTG	TTCAACGCCCCTTTGATGTG	1	0
TATATAACATTAGTGTACCG	TATATAACATTAGTGTACCG	1	0
GTGTACCTCCCTACGAGCCG	GTGTACCTCCCTACGAGCCG	1	0
GTTCTGAGCCACGTTATCTG	GTTCTGAGCCACGTTATCTG	1	0
TGTACCCGATGCTCTCCGTT	TGTACCCGATGCTCTCCGTT	1	0
GGGGAACTCACCCAGCCCGA	GGGGAACTCACCCAGCCCGA	1	0
CATCGACCAGTCAGTCTCTG	CATCGACCAGTCAGTCTCTG	1	0
TGCCACAATCTGGAGGTTTA	TGCCACAATCTGGAGGTTTA	1	0
CCTCCATCATCCAACATGCT	CCTCCATCATCCAACATGCT	1	0
CTCACAGATAGCCACCGCGG	CTCACAGATAGCCACCGCGG	1	0
GCAAGTTACAATAAGGCTAG	GCAAGTTACAATAAGGCTAG	1	0
TCCCTATAGAGCTAGAAATA	TCCCTATAGAGCTAGAAATA	1	0
TCGTGTAGCAAGTTAAAATA	TCGTGTAGCAAGTTAAAATA	1	0
ACATGACATACCCCTTGAAG	ACATGACATACCCCTTGAAG	1	0
ACCTTAATGACTACGTTTAG	ACCTTAATGACTACGTTTAG	1	0
TTCCACTTCCTTATCGCTAT	TTCCACTTCCTTATCGCTAT	1	0
GAGCTAGAAATAGCAAGTTA	GAGCTAGAAATAGCAAGTTA	1	2
TTCCGAGGCACGGCCACGTG	TTCCGAGGCACGGCCACGTG	1	0
TCTCAGAGTAATTCTTTAAA	TCTCAGAGTAATTCTTTAAA	1	0
CTCCATCGACGTCATAATGT	CTCCATCGACGTCATAATGT	1	0
GCGGGAGCGATACCACATCC	GCGGGAGCGATACCACATCC	1	0
AACAACACAGCTAATGCATA	AACAACACAGCTAATGCATA	1	0
GTGTGTGATCTCAGCCACGG	GTGTGTGATCTCAGCCACGG	1	0
ATTGTCCGGCGAGGACGTGC	ATTGTCCGGCGAGGACGTGC	1	0
ACTTGACCCAGCTCATCTGG	ACTTGACCCAGCTCATCTGG	1	0
TCTGTAGATGATGACGATCG	TCTGTAGATGATGACGATCG	1	0
GCCTGTACTGGTACATCCCG	GCCTGTACTGGTACATCCCG	1	0
GCCATCGTCTTATCCGCACC	GCCATCGTCTTATCCGCACC	1	0
CGCCCTACCTGCCGAGCCGC	CGCCCTACCTGCCGAGCCGC	1	0
CTGCCGTGCACGATGTTATC	CTGCCGTGCACGATGTTATC	1	0
TACCCATTTAACTGCTATTG	TACCCATTTAACTGCTATTG	1	0
CAAAGAACTGCACGTGATAC	CAAAGAACTGCACGTGATAC	1	0
TAAGCGAATAAACGTTGATA	TAAGCGAATAAACGTTGATA	1	0
CGACTCTTGGCCAATCCCCT	CGACTCTTGGCCAATCCCCT	1	1
GCACTCAGTGCGAAGTCAAG	GCACTCAGTGCGAAGTCAAG	1	0
ACACTGCGTGTCTCCCAGTT	ACACTGCGTGTCTCCCAGTT	1	0
CCGTCCCACCCGACTTATTG	CCGTCCCACCCGACTTATTG	1	0
TGTCACAGTTCTCGCAGCAC	TGTCACAGTTCTCGCAGCAC	1	0
CGCCAGCATCGAAAGGTACG	CGCCAGCATCGAAAGGTACG	1	0
GCAGCCGTATCAACTTGAAA	GCAGCCGTATCAACTTGAAA	1	0
CAATGGCGGCAGTCGCGCTC	CAATGGCGGCAGTCGCGCTC	1	0
TTTACATGACTTCCAAGCGT	TTTACATGACTTCCAAGCGT	1	0
GTGTCCGTTCTCAACTTGAA	GTGTCCGTTCTCAACTTGAA	1	2
CATTGGGCATTAACATTTGT	CATTGGGCATTAACATTTGT	1	0
ACCGAACATGCGATCCTCCG	ACCGAACATGCGATCCTCCG	1	0
GTTGCACGTAAACTTGCGCG	GTTGCACGTAAACTTGCGCG	1	0
TGCAAACTTACCTGGGGCTG	TGCAAACTTACCTGGGGCTG	1	0
CGGCATTCATGTACCTCCAG	CGGCATTCATGTACCTCCAG	1	0
TCTGGCAGGCCACCGTTTAG	TCTGGCAGGCCACCGTTTAG	1	0
TCCGTTTTTTCGAGTTTAGA	TCCGTTTTTTCGAGTTTAGA	1	0
TGCGATGCTGACGTTCTCAG	TGCGATGCTGACGTTCTCAG	1	0
TCGCCAAGAGGGCGCAATCG	TCGCCAAGAGGGCGCAATCG	1	0
TAACAGAGTTTGCCATGCTC	TAACAGAGTTTGCCATGCTC	1	0
CAGCGCTAGCAGACCAGGTT	CAGCGCTAGCAGACCAGGTT	1	0
CGTCACATCATTCAACTCCT	CGTCACATCATTCAACTCCT	1	0
AACGAAACACCTTCCGATGT	AACGAAACACCTTCCGATGT	1	0
TCACCCGCTCATCAAATCCG	TCACCCGCTCATCAAATCCG	1	0
CTGACCGCCCTTAGCGTTAG	CTGACCGCCCTTAGCGTTAG	1	0
AACACCTGTCAGCCGACTGT	AACACCTGTCAGCCGACTGT	1	0
AATTCCTCTAGAGCTAGAAA	AATTCCTCTAGAGCTAGAAA	1	0
TCCGGCAGCAGGTCTCGTAC	TCCGGCAGCAGGTCTCGTAC	1	0
ACCGGCAGAAGCCCCTGACG	ACCGGCAGAAGCCCCTGACG	1	0
GCGCCCTGCGCTCCTTCCGC	GCGCCCTGCGCTCCTTCCGC	1	0
AACTACTGACGTCGCACTAG	AACTACTGACGTCGCACTAG	1	0
GCCCTGAGAGACACCGCCTG	GCCCTGAGAGACACCGCCTG	1	0
TTCAAGCAAGTTAAAATAAG	TTCAAGCAAGTTAAAATAAG	1	0
TGGGCACTGACCGTGGGCAG	TGGGCACTGACCGTGGGCAG	1	0
TGAAGTCCTGCGCGATCTCA	TGAAGTCCTGCGCGATCTCA	1	0
TCGCGACTACAGAGCCCCGG	TCGCGACTACAGAGCCCCGG	1	0
CAGCGCCATCTCGTAGGTTA	CAGCGCCATCTCGTAGGTTA	1	0
ACCTCCAGGCTGGTCCGTTA	ACCTCCAGGCTGGTCCGTTA	1	0
AGCGACTACGACTCTGTTGT	AGCGACTACGACTCTGTTGT	1	0
TGAAGATTGAAAGTTAAAAT	TGAAGATTGAAAGTTAAAAT	1	0
CTTGTCTCAAATCAGCTACT	CTTGTCTCAAATCAGCTACT	1	0
GCGTTTTCATCCTGTCGCGT	GCGTTTTCATCCTGTCGCGT	1	0
ACTTGAGACAAGCTCTCGCG	ACTTGAGACAAGCTCTCGCG	1	0
TCCAAAACTCCTTTACCAAG	TCCAAAACTCCTTTACCAAG	1	0
TGACCTCGACTGCTCTGACG	TGACCTCGACTGCTCTGACG	1	0
TCTTGTTCCGATACACCGAT	TCTTGTTCCGATACACCGAT	1	0
ACGCTTGAGCGACGAGACCG	ACGCTTGAGCGACGAGACCG	1	0
ACGCCCAGCGCTCGTACACT	ACGCCCAGCGCTCGTACACT	1	0
TTGCGAATGTTACCATCTCG	TTGCGAATGTTACCATCTCG	1	0
ATAACGTGATCACAGACATG	ATAACGTGATCACAGACATG	1	0
ACGAGATGTCCCGCGCCAGG	ACGAGATGTCCCGCGCCAGG	1	0
AACTCGCGATGCCATCTCCG	AACTCGCGATGCCATCTCCG	1	0
TGTTCTCCTGCGCCTGCACG	TGTTCTCCTGCGCCTGCACG	1	0
ACTTACCAACTACCATATGT	ACTTACCAACTACCATATGT	1	0
AACCACTGCGTCCTTATCGT	AACCACTGCGTCCTTATCGT	1	0
CTGTGACCCATGCCTCCAAG	CTGTGACCCATGCCTCCAAG	1	0
TAGCTTACTCGAAATTCACG	TAGCTTACTCGAAATTCACG	1	0
GTGACTCCAGCTATCCAGGT	GTGACTCCAGCTATCCAGGT	1	0
TACTCACTCGGCAAACTTGG	TACTCACTCGGCAAACTTGG	1	0
CTTCAAGTTAAAATACGGCT	CTTCAAGTTAAAATACGGCT	1	0
ACCCCATCCTTTCATTGAGG	ACCCCATCCTTTCATTGAGG	1	0
ACACCATTTAGAGCGTGTCT	ACACCATTTAGAGCGTGTCT	1	0
TAGGCTTACCTAGTTTGCAC	TAGGCTTACCTAGTTTGCAC	1	0
CTCCAGAACCTGCCCAAGAA	CTCCAGAACCTGCCCAAGAA	1	0
TTTTCCAGCACTCGAATGCG	TTTTCCAGCACTCGAATGCG	1	0
TCCCGCGAGACGAGCTGCGT	TCCCGCGAGACGAGCTGCGT	1	0
CTCGTCGCAGCCCACAAGCA	CTCGTCGCAGCCCACAAGCA	1	0
CCCCCCCACTCTCAACGGGT	CCCCCCCACTCTCAACGGGT	1	0
TCTCTCCGCGCAGCAACTCA	TCTCTCCGCGCAGCAACTCA	1	0
GCTTACATAGCAAATCTATG	GCTTACATAGCAAATCTATG	1	0
TCTGGTGATCTCTCCCGAGT	TCTGGTGATCTCTCCCGAGT	1	0
CCGTATCCCCACTCTCATCA	CCGTATCCCCACTCTCATCA	1	0
ACATTTGTTCTGCAAAGACA	ACATTTGTTCTGCAAAGACA	1	0
ATCATGTTTCTAAAGCCGCG	ATCATGTTTCTAAAGCCGCG	1	0
TTCCAAAATACGACTTTACC	TTCCAAAATACGACTTTACC	1	0
ATCAGTTTTAGAGCTAGAAA	ATCAGTTTTAGAGCTAGAAA	1	1
CCGTTCTCAACTTGAAAAAG	CCGTTCTCAACTTGAAAAAG	1	0
CTGCATATCTTCGAGATGCT	CTGCATATCTTCGAGATGCT	1	0
ACTTCGACACGACCTCTACG	ACTTCGACACGACCTCTACG	1	0
CTCCTCGAAGGGCCGACACG	CTCCTCGAAGGGCCGACACG	1	0
TGTGTACAGCTCTCCTCCGT	TGTGTACAGCTCTCCTCCGT	1	0
CTTATAGTCAGCCTCAAAAG	CTTATAGTCAGCCTCAAAAG	1	0
TCCGCAGCCCTCCACACGTA	TCCGCAGCCCTCCACACGTA	1	0
CCCGATGATCTCGATGCCCG	CCCGATGATCTCGATGCCCG	1	1
TCTCCTATCAAGGCCATTCT	TCTCCTATCAAGGCCATTCT	1	0
AGGATCCTGAGACGTTCCTC	AGGATCCTGAGACGTTCCTC	1	0
TTCCCTATCAGTAGAAATAG	TTCCCTATCAGTAGAAATAG	1	0
CTGGTCTCGCCGGTAGCTAT	CTGGTCTCGCCGGTAGCTAT	1	0
CACTACCTTAGAAATAGCAC	CACTACCTTAGAAATAGCAC	0	1
CCCATCGAGATCTCTCTGAC	CCCATCGAGATCTCTCTGAC	0	1
CACCAGCCACTTACTGTGCG	CACCAGCCACTTACTGTGCG	0	1
CGCTCAGCTGCCCAAACCCA	CGCTCAGCTGCCCAAACCCA	0	1
CGGGGGAGAACCCGACGCGT	CGGGGGAGAACCCGACGCGT	0	1
GAGTCCCTGAAGATGATCTT	GAGTCCCTGAAGATGATCTT	0	1
TCCTTATCATTTGCACCACC	TCCTTATCATTTGCACCACC	0	1
GCCTGGTTTTAGAGCTAGAA	GCCTGGTTTTAGAGCTAGAA	0	1
TCACCGTCCGCTGCGACTGG	TCACCGTCCGCTGCGACTGG	0	1
TTTAGCAAGTTAAAATAAGG	TTTAGCAAGTTAAAATAAGG	0	1
ACTCACCAAGACGCCCATCT	ACTCACCAAGACGCCCATCT	0	1
ACTCTCTTACCTCTTCTCTA	ACTCTCTTACCTCTTCTCTA	0	1
CTTGATATCAATCCCACTCC	CTTGATATCAATCCCACTCC	0	5
ACCTGCATTAGACTTGAATG	ACCTGCATTAGACTTGAATG	0	1
CTTGATATCCATCCCACTCC	CTTGATATCCATCCCACTCC	0	1
AACGCCAGCCCTCGAACCAT	AACGCCAGCCCTCGAACCAT	0	1
TCGGACGCCTCACAAGGCTA	TCGGACGCCTCACAAGGCTA	0	1
TCCAAGGCCTCCCTCCACGT	TCCAAGGCCTCCCTCCACGT	0	1
CCACGCCCCAACTGGAACAG	CCACGCCCCAACTGGAACAG	0	1
CTGGGGAACTACCGGCTCAG	CTGGGGAACTACCGGCTCAG	0	1
TCAAGAACCTGTTTCTGTCG	TCAAGAACCTGTTTCTGTCG	0	1
AGCCCGCTTTTAGAGACTTG	AGCCCGCTTTTAGAGACTTG	0	1
CCTTCCCGGGCATGAGTCCG	CCTTCCCGGGCATGAGTCCG	0	4
TTCTCACACACATGCTAGGT	TTCTCACACACATGCTAGGT	0	1
CCTGGTTTTAGAGCTAGAAA	CCTGGTTTTAGAGCTAGAAA	0	1
TCTTGCAGGAGATCCCGCTG	TCTTGCAGGAGATCCCGCTG	0	1
ACCCCGACACTGCCCACAGA	ACCCCGACACTGCCCACAGA	0	1
TGCCTCCGCTACTGTCCGTT	TGCCTCCGCTACTGTCCGTT	0	1
AACGAGTGACTGGTTTTAGA	AACGAGTGACTGGTTTTAGA	0	1
TTATATGTTTATGAGCCCCG	TTATATGTTTATGAGCCCCG	0	3
CGCCCCCTGTTTTAGAGCTA	CGCCCCCTGTTTTAGAGCTA	0	1
TTGCAACGCATTCATCAGTT	TTGCAACGCATTCATCAGTT	0	1
TTCATGACTGGAGTGTACTG	TTCATGACTGGAGTGTACTG	0	1
TCAGCCACTCCCATTCACTG	TCAGCCACTCCCATTCACTG	0	1
CCCTTAATCAGATCTTCCCT	CCCTTAATCAGATCTTCCCT	0	1
GCATCACTGCAGTCATCTCT	GCATCACTGCAGTCATCTCT	0	1
TGTTTCAACTTGTCCTTGCG	TGTTTCAACTTGTCCTTGCG	0	1
CCCCTCACCTTGAAAAAGTG	CCCCTCACCTTGAAAAAGTG	0	1
TTGGTCCATTTCGAACCTCT	TTGGTCCATTTCGAACCTCT	0	1
TGCCGCCGTGTTCCTGTACA	TGCCGCCGTGTTCCTGTACA	0	1
TTTGCTGAACATCGTATAGT	TTTGCTGAACATCGTATAGT	0	1
TTTGGAGCAGAAGATTCAAT	TTTGGAGCAGAAGATTCAAT	0	1
ACTCTTCCTCACTCCGACGC	ACTCTTCCTCACTCCGACGC	0	1
GCAGGGGTAGAAATAGCAAG	GCAGGGGTAGAAATAGCAAG	0	1
TGGGCGCGCACAACTCTGCG	TGGGCGCGCACAACTCTGCG	0	1
CCTTGCTAGTGTGAACACTT	CCTTGCTAGTGTGAACACTT	0	1
TCCGTACATGGAAATCTTCT	TCCGTACATGGAAATCTTCT	0	1
GCCGACTGCCTGCCACGAGG	GCCGACTGCCTGCCACGAGG	0	1
AGCCCCAGTTCCGCGGCCGC	AGCCCCAGTTCCGCGGCCGC	0	1
GATACTCACGTGTCTCCTCC	GATACTCACGTGTCTCCTCC	0	1
GCCGCGCCTCTACGACCCGG	GCCGCGCCTCTACGACCCGG	0	1
TCCATGCCTCGGCTCATCGT	TCCATGCCTCGGCTCATCGT	0	1
CTCAAGTCTCACCCGCGTCT	CTCAAGTCTCACCCGCGTCT	0	1
GTCCTAACAGCATCGGAGCT	GTCCTAACAGCATCGGAGCT	0	1
CACCCTACCTGGCGGAATTG	CACCCTACCTGGCGGAATTG	0	1
GGGTACATACTCCAACCGCA	GGGTACATACTCCAACCGCA	0	1
TCCCTCACCTTGAAAAAGTG	TCCCTCACCTTGAAAAAGTG	0	2
CAGTGCGGATCAGCGAGAGG	CAGTGCGGATCAGCGAGAGG	0	2
TTCCAAATGAACTGTTCCAG	TTCCAAATGAACTGTTCCAG	0	1
GGCCGAGAAGACGTTCTTCG	GGCCGAGAAGACGTTCTTCG	0	1
TAGCCGATGGATGCACCGAC	TAGCCGATGGATGCACCGAC	0	1
TGTTGATGCGCAAGAGGGCG	TGTTGATGCGCAAGAGGGCG	0	1
TCAGAATACTCCATCCCATG	TCAGAATACTCCATCCCATG	0	1
ACCTCGCACCACACACCCGA	ACCTCGCACCACACACCCGA	0	1
CCTGAGTACTTCCTGCAGTT	CCTGAGTACTTCCTGCAGTT	0	1
ATTCGCCACCCGTTCCTCTC	ATTCGCCACCCGTTCCTCTC	0	1
CACCTTTTGTAGCAAGTTAA	CACCTTTTGTAGCAAGTTAA	0	2
TGTGGCCCGGCGGAAATACG	TGTGGCCCGGCGGAAATACG	0	1
CGCCCCTGCAGCGCAAGTCC	CGCCCCTGCAGCGCAAGTCC	0	1
CCAGTTGACTGTGAGCAAAG	CCAGTTGACTGTGAGCAAAG	0	1
ATACTTACCTCCATAGCATG	ATACTTACCTCCATAGCATG	0	1
CTGAGACTTTTCATCTTCCC	CTGAGACTTTTCATCTTCCC	0	1
CTTCTATATTGTCCTTCTTC	CTTCTATATTGTCCTTCTTC	0	1
AGATAGAAATAGCAAGTTAA	AGATAGAAATAGCAAGTTAA	0	2
TCATCTCTTCGTTTTGTGCG	TCATCTCTTCGTTTTGTGCG	0	1
TTCAGGATGGATCTATCGTT	TTCAGGATGGATCTATCGTT	0	2
TTCGATCTCCGTACTTGGTT	TTCGATCTCCGTACTTGGTT	0	1
CCCTCCGGATGGGGTTCTTC	CCCTCCGGATGGGGTTCTTC	0	2
CCAAGTCCGTTATCAACTTG	CCAAGTCCGTTATCAACTTG	0	1
GGTGGCTCCTGCGCCTGCGC	GGTGGCTCCTGCGCCTGCGC	0	1
GCGCTGGTAGGCATCATCGC	GCGCTGGTAGGCATCATCGC	0	1
AGAGTTCAGCTTCCTCCTTT	AGAGTTCAGCTTCCTCCTTT	0	1
TAATGAAAATCCCGACCTCT	TAATGAAAATCCCGACCTCT	0	1
GATCTCTCAGAATGATGTCC	GATCTCTCAGAATGATGTCC	0	1
TCAGTGCTTGAATCTGTTCG	TCAGTGCTTGAATCTGTTCG	0	1
CATCTAGAAATAGCAAGTTA	CATCTAGAAATAGCAAGTTA	0	2
CCCGAAACTGACCTGCTTTC	CCCGAAACTGACCTGCTTTC	0	1
TCTCCCACCATCTTTCACGG	TCTCCCACCATCTTTCACGG	0	1
CTCCTTCCGTGATTTTTACC	CTCCTTCCGTGATTTTTACC	0	1
TCTCTCCGCGCAGCACTTTG	TCTCTCCGCGCAGCACTTTG	0	1
GCCTACCCGAGCCGAACCGT	GCCTACCCGAGCCGAACCGT	0	2
TTTGCAAGTTAAAATAAGGC	TTTGCAAGTTAAAATAAGGC	0	3
ACTCACGCTTTGCTCCCTGT	ACTCACGCTTTGCTCCCTGT	0	1
TGACACTGCGCCGCTTCATG	TGACACTGCGCCGCTTCATG	0	2
ACCGTGGCCATGATCATGAT	ACCGTGGCCATGATCATGAT	0	1
CACTTCACCACCCGATGTAG	CACTTCACCACCCGATGTAG	0	1
CTCTCCGATGAGTCATCGGT	CTCTCCGATGAGTCATCGGT	0	1
CACCTGGGAAGACCGCCAAG	CACCTGGGAAGACCGCCAAG	0	1
AGTGAATGCCCAATTTTAGG	AGTGAATGCCCAATTTTAGG	0	1
CCAAATGTCACTGCATCATT	CCAAATGTCACTGCATCATT	0	1
ATCAACACAGCCTCTTCTGT	ATCAACACAGCCTCTTCTGT	0	1
TGCTAGAAATAGCAAGTTAA	TGCTAGAAATAGCAAGTTAA	0	1
ACCACTGACCGATTTGATCC	ACCACTGACCGATTTGATCC	0	1
TTTATTTCCAGCTCCGCCAC	TTTATTTCCAGCTCCGCCAC	0	1
CGCTTGACCATAGGCTCCCG	CGCTTGACCATAGGCTCCCG	0	1
TGTGACAGCTGCCTGTTCCG	TGTGACAGCTGCCTGTTCCG	0	1
CAGGAGCAGTCTGTGCCCCG	CAGGAGCAGTCTGTGCCCCG	0	1
CATCACCGGGTTCGGGTGGT	CATCACCGGGTTCGGGTGGT	0	1
ATAACTGCATGACAGACACT	ATAACTGCATGACAGACACT	0	1
TCCGAGGTCTGTCGATATTT	TCCGAGGTCTGTCGATATTT	0	1
CTTATCCCCTTCATAGCAGT	CTTATCCCCTTCATAGCAGT	0	1
GAGAAACCCTATAGATGTTG	GAGAAACCCTATAGATGTTG	0	1
CTCCACCTCGAGTTCCATTG	CTCCACCTCGAGTTCCATTG	0	1
ACCTTCCTGTTACTGTACGT	ACCTTCCTGTTACTGTACGT	0	1
AGCTGAAGATATCCTTCGCA	AGCTGAAGATATCCTTCGCA	0	1
TACTTAACACGGTGCCTGTG	TACTTAACACGGTGCCTGTG	0	1
ACCTGGCCAACCTCGTTCCT	ACCTGGCCAACCTCGTTCCT	0	1
TTTCCGATCTGAGCTGTAGT	TTTCCGATCTGAGCTGTAGT	0	1
ACAGCGTCAGAACATCTTGA	ACAGCGTCAGAACATCTTGA	0	1
CCCCCCTCCGTAACTCGGCG	CCCCCCTCCGTAACTCGGCG	0	1
ACCAACTCCAATTCAGTCCG	ACCAACTCCAATTCAGTCCG	0	1
CTCCCATCTGCTGATTCCTG	CTCCCATCTGCTGATTCCTG	0	1
GCACCTACCCATAGTCCCAG	GCACCTACCCATAGTCCCAG	0	2
GGTGGTCGAGCTTTCCATCA	GGTGGTCGAGCTTTCCATCA	0	1
ACCCTGCTGTGTCTCTATGT	ACCCTGCTGTGTCTCTATGT	0	1
CTAGCATCTTCGCACTGTGT	CTAGCATCTTCGCACTGTGT	0	1
TTAGTCTGGTCATCTTGCCA	TTAGTCTGGTCATCTTGCCA	0	1
TTCGTGTGGTCTCTACCATG	TTCGTGTGGTCTCTACCATG	0	1
CGAAGGTGACATCCGTGTCG	CGAAGGTGACATCCGTGTCG	0	1
GCCATACACCACACGCCGTA	GCCATACACCACACGCCGTA	0	1
CGCCTGCGCCCAATGAACCG	CGCCTGCGCCCAATGAACCG	0	1
GCTTGTGACCATTCACTCCG	GCTTGTGACCATTCACTCCG	0	1
ATACATCGATACATTCAGTG	ATACATCGATACATTCAGTG	0	1
TCCTTCCTTGGGTTCTCACG	TCCTTCCTTGGGTTCTCACG	0	1
GATGGTGTCGCACCAGCACT	GATGGTGTCGCACCAGCACT	0	1
CGCTCCACATTTTTCAATCT	CGCTCCACATTTTTCAATCT	0	1
ATGAGAGAGAAATAGCAAGT	ATGAGAGAGAAATAGCAAGT	0	1
CGGCCACGCTACTACAGTTG	CGGCCACGCTACTACAGTTG	0	1
GCATAGCTGATGTGCAGTTG	GCATAGCTGATGTGCAGTTG	0	1
CTTAGTTGGATCAGCGTTAG	CTTAGTTGGATCAGCGTTAG	0	2
ACCTAGCTCCCTTTGGGGAG	ACCTAGCTCCCTTTGGGGAG	0	1
CAGCAAGCGGACACGCGAAG	CAGCAAGCGGACACGCGAAG	0	1
GAATGCTACTATGATATTGT	GAATGCTACTATGATATTGT	0	1
GGCGGAGTTTGCCCGATTAC	GGCGGAGTTTGCCCGATTAC	0	1
TCACACATCCCTTCGTTTTA	TCACACATCCCTTCGTTTTA	0	1
CCTCGTCCCTCCGTTGACGG	CCTCGTCCCTCCGTTGACGG	0	1
CTGGAGTTAGAACTAGCAAG	CTGGAGTTAGAACTAGCAAG	0	1
TACTGCCTCCCACAACCGCA	TACTGCCTCCCACAACCGCA	0	1
TTATCTATACCTACTAGACA	TTATCTATACCTACTAGACA	0	1
CTTCTGCTCGTTTTAGAGCT	CTTCTGCTCGTTTTAGAGCT	0	2
ACGCAGTAAACACTTTCTCG	ACGCAGTAAACACTTTCTCG	0	1
CCCTCCGGATGGGTTCTTCT	CCCTCCGGATGGGTTCTTCT	0	1
TCACACTGATGAGTCCAACC	TCACACTGATGAGTCCAACC	0	1
GTTTTTGCAGTAGCGCTGCT	GTTTTTGCAGTAGCGCTGCT	0	2
CTACCACGAACTCCCTATCC	CTACCACGAACTCCCTATCC	0	1
TGTTTTAGAGCTAGAAATAG	TGTTTTAGAGCTAGAAATAG	0	1
CCCCGCGCTTCAGCTCTGCG	CCCCGCGCTTCAGCTCTGCG	0	1
ATCTGTATCCTCGTATCTTA	ATCTGTATCCTCGTATCTTA	0	1
CCTCCACGGAGTACTGTCCA	CCTCCACGGAGTACTGTCCA	0	1
TCTTGACACCTGTACATTTG	TCTTGACACCTGTACATTTG	0	1
TCGCTACTACAGACACCCGG	TCGCTACTACAGACACCCGG	0	1
CCGCTTCCTTCTACAGCTTG	CCGCTTCCTTCTACAGCTTG	0	1
GCTACGACTGCTAGACAAGT	GCTACGACTGCTAGACAAGT	0	1
ACACCTGTTCGAGCAGTATG	ACACCTGTTCGAGCAGTATG	0	1
GACCATCTGTGAACACCGTT	GACCATCTGTGAACACCGTT	0	1
TCATTTAATCCTTTGTTTCC	TCATTTAATCCTTTGTTTCC	0	1
CAAGAGCTAGAAATAGCAAG	CAAGAGCTAGAAATAGCAAG	0	1
CCTCTCTTACCTAGTTTCTG	CCTCTCTTACCTAGTTTCTG	0	1
TATACAGTGTTAATTACCGG	TATACAGTGTTAATTACCGG	0	1
ACTCCGCCGCGATGTGACCG	ACTCCGCCGCGATGTGACCG	0	1
CCCTCGACAGCACTCGCGAT	CCCTCGACAGCACTCGCGAT	0	1
TGACTCACCTTCTAGGACAT	TGACTCACCTTCTAGGACAT	0	1
GCTGAGCCCGATGCTTCCCA	GCTGAGCCCGATGCTTCCCA	0	1
TGCCACGCAGCTGCCCGTGA	TGCCACGCAGCTGCCCGTGA	0	1
CTTCCGTTCCTTGTCCGCAG	CTTCCGTTCCTTGTCCGCAG	0	1
CTTGCCGCTGTCCGTTATCA	CTTGCCGCTGTCCGTTATCA	0	1
CCACTTCCTCGAAAGACAAA	CCACTTCCTCGAAAGACAAA	0	1
CGCTCCCGCCGGCATTCTTT	CGCTCCCGCCGGCATTCTTT	0	1
GATCCGTTCCTCCACGTGTG	GATCCGTTCCTCCACGTGTG	0	1
CATGTGCCCCCCTATGACGG	CATGTGCCCCCCTATGACGG	0	1
CCTTACTTGCAATCGTTGTT	CCTTACTTGCAATCGTTGTT	0	1
GCCGAGACTACAGCGAACCC	GCCGAGACTACAGCGAACCC	0	1
CCATGTGTACTGATTTTCCT	CCATGTGTACTGATTTTCCT	0	1
TGTGGAGGTGACCTTCTCCA	TGTGGAGGTGACCTTCTCCA	0	1
ACCATCACCTTTCCATGTCT	ACCATCACCTTTCCATGTCT	0	1
GCAACTCCGTGGAGCCGTGT	GCAACTCCGTGGAGCCGTGT	0	1
CCAGCAGCTACCTGATTTCG	CCAGCAGCTACCTGATTTCG	0	1
TGGCGCGAAACTTCCGCAAC	TGGCGCGAAACTTCCGCAAC	0	1
CCCCCGATACCGTCAGACCT	CCCCCGATACCGTCAGACCT	0	1
ATGCCATAGGCTTCTTGCAA	ATGCCATAGGCTTCTTGCAA	0	1
CCTGCATGACTTTGTGTGGT	CCTGCATGACTTTGTGTGGT	0	1
ACTTTCGTGTATCATGTAGT	ACTTTCGTGTATCATGTAGT	0	1
CCATCACCACCAAGAATTGC	CCATCACCACCAAGAATTGC	0	1
CGGAAGACCTTCTTCAGCCG	CGGAAGACCTTCTTCAGCCG	0	1
CGCTGACTCACCCCACTCGG	CGCTGACTCACCCCACTCGG	0	1
CTAGAAAACTTACCTCCCCA	CTAGAAAACTTACCTCCCCA	0	1
CAGCCCCCATACTCACCAAG	CAGCCCCCATACTCACCAAG	0	1
TGCACTGCAGCTAGCCGCTG	TGCACTGCAGCTAGCCGCTG	0	1
AGGGCTCTCGCACAGCCGCG	AGGGCTCTCGCACAGCCGCG	0	1
TATCAGTTTTCCAGTAAACT	TATCAGTTTTCCAGTAAACT	0	1
GGCGTAGTACCTGTCTTTGT	GGCGTAGTACCTGTCTTTGT	0	1
CCGCTATACTCCAAGTTCCG	CCGCTATACTCCAAGTTCCG	0	1
ATCCCTTCTCCAGTCGTGAT	ATCCCTTCTCCAGTCGTGAT	0	1
GAGAGCTTGAAATAGCAAGT	GAGAGCTTGAAATAGCAAGT	0	1
GACTAAAGAGTTCGCATTAG	GACTAAAGAGTTCGCATTAG	0	1
GCCACGGCAGACTAGTCCGT	GCCACGGCAGACTAGTCCGT	0	1
TCTTATCAGTTCCAGTGAGG	TCTTATCAGTTCCAGTGAGG	0	1
TGCTGAATACCAGGTGGGAT	TGCTGAATACCAGGTGGGAT	0	1
GCTTCAACCTGCTCCTCTTT	GCTTCAACCTGCTCCTCTTT	0	1
TGAGCCCGCAGGCGAAGATC	TGAGCCCGCAGGCGAAGATC	0	1
CCTGTGGTGTGCCCCTACCG	CCTGTGGTGTGCCCCTACCG	0	1
CATGCAAGTTAAAATAAGGC	CATGCAAGTTAAAATAAGGC	0	2
TTCAACGCAGTCCACGTCAG	TTCAACGCAGTCCACGTCAG	0	1
AATGGTCCAAAAGAGCTTTA	AATGGTCCAAAAGAGCTTTA	0	1
TCTCCAAATAATACAACCGT	TCTCCAAATAATACAACCGT	0	1
CCGGGAGGATGAGAATCTTG	CCGGGAGGATGAGAATCTTG	0	1
CTTTCCCAATTTCTAGTGTG	CTTTCCCAATTTCTAGTGTG	0	1
AGGCCTTCAGGCGCTATGCT	AGGCCTTCAGGCGCTATGCT	0	1
TCTCGTTAGACGTTCTCCTC	TCTCGTTAGACGTTCTCCTC	0	1
TTGCTTTTGTGATTTCTTGA	TTGCTTTTGTGATTTCTTGA	0	1
TGGAGCACACGCGGCAGCGC	TGGAGCACACGCGGCAGCGC	0	1
GCCGCTTGCCAAACGTATTA	GCCGCTTGCCAAACGTATTA	0	1
GTGCATTTGCGACTCCTCCC	GTGCATTTGCGACTCCTCCC	0	1
ACCAACCATGCTGACTCCGT	ACCAACCATGCTGACTCCGT	0	1
GGTCCAGAATTTTGTACGTG	GGTCCAGAATTTTGTACGTG	0	1
ACCCTGGCTCCATGCTTAGT	ACCCTGGCTCCATGCTTAGT	0	1
TACCGCTGTGCGGCTACTCG	TACCGCTGTGCGGCTACTCG	0	1
TCCGCACGCTGTTCCCCTCG	TCCGCACGCTGTTCCCCTCG	0	1
GCCTTAACGGCATGGTGATC	GCCTTAACGGCATGGTGATC	0	1
CAGAACTAGAAATAGCAAGT	CAGAACTAGAAATAGCAAGT	0	2
TTGCCTATCAGTAGAAATAG	TTGCCTATCAGTAGAAATAG	0	1
TCTACGCCACACGCTTCTGT	TCTACGCCACACGCTTCTGT	0	1
TCTCGCTGGGAGCGATCAAC	TCTCGCTGGGAGCGATCAAC	0	1
ATTTGCCGCGCATCACCTTC	ATTTGCCGCGCATCACCTTC	0	1
CTGTTGACTCCGCAGAAGAA	CTGTTGACTCCGCAGAAGAA	0	1
TGGTTAACATGCCAGGGAGC	TGGTTAACATGCCAGGGAGC	0	1
CGAGCATGTCATCACAGAAG	CGAGCATGTCATCACAGAAG	0	1
CCGGTCCAGTTCCTGTTGGT	CCGGTCCAGTTCCTGTTGGT	0	1
TATTCTGCATCTGATGATGC	TATTCTGCATCTGATGATGC	0	1
TTATTAGCTCGAGGAAGAGT	TTATTAGCTCGAGGAAGAGT	0	1
TTGTGATGATGACCACGAAC	TTGTGATGATGACCACGAAC	0	1
TCTACATTATACATTTCGTT	TCTACATTATACATTTCGTT	0	1
CTGCTTGCGTCATTCTGTTT	CTGCTTGCGTCATTCTGTTT	0	2
GACCACCTGATCCTGCAGAT	GACCACCTGATCCTGCAGAT	0	2
CTAGTACGAAGTGTCCCTCG	CTAGTACGAAGTGTCCCTCG	0	1
TAAGTCTCAGCGTAATCTTG	TAAGTCTCAGCGTAATCTTG	0	1
GCACGAGTGCTGTGCTTCCG	GCACGAGTGCTGTGCTTCCG	0	2
CTCATTAATAATGCCCGATG	CTCATTAATAATGCCCGATG	0	1
AGCCCCGTTTCCCAGCTCGC	AGCCCCGTTTCCCAGCTCGC	0	1
TCAGGCCGCTCGACTCCGTA	TCAGGCCGCTCGACTCCGTA	0	1
CAGTGATTGCCTTAACCATA	CAGTGATTGCCTTAACCATA	0	1
CAGCTCCATGATGCGTTATT	CAGCTCCATGATGCGTTATT	0	1
CTGGACAATGCCATCGACTG	CTGGACAATGCCATCGACTG	0	1
TGCTTCCTGGCGCCAGCTCG	TGCTTCCTGGCGCCAGCTCG	0	1
CACCAGGAGGTGTCTTGTTG	CACCAGGAGGTGTCTTGTTG	0	2
AGGTACCGAAACTACATTGT	AGGTACCGAAACTACATTGT	0	1
GGTCTCATTGCTATATTGAT	GGTCTCATTGCTATATTGAT	0	1
TGACAATACCTCGTTGTTGT	TGACAATACCTCGTTGTTGT	0	1
GACCTAAAGACTCCATGCTC	GACCTAAAGACTCCATGCTC	0	1
CATCTACAGTGAAGCAGACC	CATCTACAGTGAAGCAGACC	0	1
AGAAAATTTTGAGCTAGAAA	AGAAAATTTTGAGCTAGAAA	0	1
AAACACCGCTCGGGCAGCGC	AAACACCGCTCGGGCAGCGC	0	1
CTTGCCTTCCTACGAGCCCG	CTTGCCTTCCTACGAGCCCG	0	1
GAGTGAACACCTCAGTCTCT	GAGTGAACACCTCAGTCTCT	0	1
ACGAGAAGTTAAAATAAGGC	ACGAGAAGTTAAAATAAGGC	0	2
GCATCAGATCATCATCCTCA	GCATCAGATCATCATCCTCA	0	1
ATTACATGACGCCCACATGT	ATTACATGACGCCCACATGT	0	1
TGCCTGAAGCGTCTAATCAG	TGCCTGAAGCGTCTAATCAG	0	1
ATCACAGAGACCATCTTCTA	ATCACAGAGACCATCTTCTA	0	1
AGCTAGAAATAGCAAGTTGA	AGCTAGAAATAGCAAGTTGA	0	2
TGTCTTGCAGCGATTTTAGA	TGTCTTGCAGCGATTTTAGA	0	1
ACCGGCTTGCTCCCAGGACG	ACCGGCTTGCTCCCAGGACG	0	1
AATTTACCTCCTAGAAATAG	AATTTACCTCCTAGAAATAG	0	1
ACACCACAGACACTGTTGTG	ACACCACAGACACTGTTGTG	0	1
GCGAATGCACCGAAACCTTA	GCGAATGCACCGAAACCTTA	0	1
GACCTCACCGTCAGAGGGCG	GACCTCACCGTCAGAGGGCG	0	1
GTGGTACAGCACCACAGTGT	GTGGTACAGCACCACAGTGT	0	1
AGCTGGCACTGGGCATTGCG	AGCTGGCACTGGGCATTGCG	0	1
GACCATCTGATCAAACGTCG	GACCATCTGATCAAACGTCG	0	1
GGGCTCATCGCCTGGCCAGT	GGGCTCATCGCCTGGCCAGT	0	1
GGACCATCTGCTGAACCCCG	GGACCATCTGCTGAACCCCG	0	1
GGCCTGAGGCTGTGCGCACG	GGCCTGAGGCTGTGCGCACG	0	1
CAATAACGCCACACTTCATT	CAATAACGCCACACTTCATT	0	1
GTCCCTGTTGTCTGACCACC	GTCCCTGTTGTCTGACCACC	0	1
AGTGTCATCTGGGATCGCCG	AGTGTCATCTGGGATCGCCG	0	1
CGAGCAGCACTCATGCGAGT	CGAGCAGCACTCATGCGAGT	0	2
TCGAGTGCGGGATGTTTTTG	TCGAGTGCGGGATGTTTTTG	0	1
GACTTTATCCGAACGGTTCG	GACTTTATCCGAACGGTTCG	0	1
CGTCATAATCATATCTGAGG	CGTCATAATCATATCTGAGG	0	1
CTTTCACCTACTTGAAAAAG	CTTTCACCTACTTGAAAAAG	0	1
TCAGACTCGTCAGACCCGCT	TCAGACTCGTCAGACCCGCT	0	1
CAGTCCGTTCTCAACTTGAA	CAGTCCGTTCTCAACTTGAA	0	2
AGCAGAGATTTAGCAAGTTA	AGCAGAGATTTAGCAAGTTA	0	1
CTCAAGATGCGATCAGCAGG	CTCAAGATGCGATCAGCAGG	0	1
TATGCATCCCACCTGTCGCC	TATGCATCCCACCTGTCGCC	0	1
GAGCTCAATCTCTGCACTGC	GAGCTCAATCTCTGCACTGC	0	1
TCTTTTCCGGTGATCGCAGC	TCTTTTCCGGTGATCGCAGC	0	1
ACTTGACCACAAGCAAGTTA	ACTTGACCACAAGCAAGTTA	0	2
CTCGTCAACTCCTGACTTAC	CTCGTCAACTCCTGACTTAC	0	1
CGTGGTTGCTTCCTCCACGT	CGTGGTTGCTTCCTCCACGT	0	1
TGAAACCTGGTAGTAAAATT	TGAAACCTGGTAGTAAAATT	0	1
AACCCCATACTTTGTGATCG	AACCCCATACTTTGTGATCG	0	1
CCGTTTTAGAGCTAGAAATA	CCGTTTTAGAGCTAGAAATA	0	1
ATAGAGGATCACGTAATTGT	ATAGAGGATCACGTAATTGT	0	1
ACCTCTTGCATCATTCCTGG	ACCTCTTGCATCATTCCTGG	0	1
TATGCCTCCACCTGTCGCCG	TATGCCTCCACCTGTCGCCG	0	1
GTCAGCTGTTCAATAGAGCT	GTCAGCTGTTCAATAGAGCT	0	1
CAGCCGGTGAGAACCTCTAG	CAGCCGGTGAGAACCTCTAG	0	1
TTTACCACCAGGTTGTTCAG	TTTACCACCAGGTTGTTCAG	0	1
TGGAACCTGCACGATTTAGA	TGGAACCTGCACGATTTAGA	0	1
GCACCGATTCCAACTGTGGT	GCACCGATTCCAACTGTGGT	0	1
CATGACATCCTTTGCCCGGT	CATGACATCCTTTGCCCGGT	0	1
GCTGCACAGTGCAGTCATTG	GCTGCACAGTGCAGTCATTG	0	1
CGACACCTGTTTTAGAGCTA	CGACACCTGTTTTAGAGCTA	0	1
ACCCGCCATGTCGACCTTGT	ACCCGCCATGTCGACCTTGT	0	1
GCTCCATTGACACCTGTTTT	GCTCCATTGACACCTGTTTT	0	1
GATTCTTCTAGAGTTTTTTG	GATTCTTCTAGAGTTTTTTG	0	1
TGTGTAAATACTCAATCAGT	TGTGTAAATACTCAATCAGT	0	1
TCGCCCTCACGTCAATGTCT	TCGCCCTCACGTCAATGTCT	0	1
GGAAGATGATGCTTTTATAA	GGAAGATGATGCTTTTATAA	0	1
CCCTCGTTCTTCGTATGACG	CCCTCGTTCTTCGTATGACG	0	1
GAAGACTTTACCGGCGTTCG	GAAGACTTTACCGGCGTTCG	0	1
CAACGCCACCAATTCCAACA	CAACGCCACCAATTCCAACA	0	1
AATTTTACTTACGCAACTTG	AATTTTACTTACGCAACTTG	0	1
GATTAAGCACCCACTCCACG	GATTAAGCACCCACTCCACG	0	1
TTTGCCAGACCCCACCCCCG	TTTGCCAGACCCCACCCCCG	0	1
ATGCATGGGCCGCTGCCGTT	ATGCATGGGCCGCTGCCGTT	0	1
GCAGTTGCCTTCACGATTTA	GCAGTTGCCTTCACGATTTA	0	1
TTGTAATTGGCATCCGGGCT	TTGTAATTGGCATCCGGGCT	0	1
CTGAAGGCTGTGTCTCACAA	CTGAAGGCTGTGTCTCACAA	0	1
ATCCTCCTTTGTCGTTTTAG	ATCCTCCTTTGTCGTTTTAG	0	1
GCCGCGGGTTCCCGCTCTAC	GCCGCGGGTTCCCGCTCTAC	0	1
CCATCTTCGAGCTAGAAATA	CCATCTTCGAGCTAGAAATA	0	2
TCTAACACTTCCGCACCACG	TCTAACACTTCCGCACCACG	0	1
TCAAGAATGAGATGGCTTCT	TCAAGAATGAGATGGCTTCT	0	1
CCAATAGTTCTGTCTTGTTC	CCAATAGTTCTGTCTTGTTC	0	1
CACGGTAGCGTAGGATTTAC	CACGGTAGCGTAGGATTTAC	0	1
ACAGAGACTTACTTGTTCAT	ACAGAGACTTACTTGTTCAT	0	1
CGTAGTCAGCCATGCAACTC	CGTAGTCAGCCATGCAACTC	0	1
AGCGTAGAGCTAGAAATAGC	AGCGTAGAGCTAGAAATAGC	0	1
TTATCAAATTGAAAAAGTGG	TTATCAAATTGAAAAAGTGG	0	1
TTGCAGATCAAACCATCCGG	TTGCAGATCAAACCATCCGG	0	1
TAGCTAGGCCTCCGTTTTTT	TAGCTAGGCCTCCGTTTTTT	0	1
ACGGGGGTAAAGTTTCTCGT	ACGGGGGTAAAGTTTCTCGT	0	1
CTTGGCCGTGTCACCCGCGT	CTTGGCCGTGTCACCCGCGT	0	1
CACTTAAAATAGCAAGTTAA	CACTTAAAATAGCAAGTTAA	0	1
TAGGATAACCGTGATTGTTC	TAGGATAACCGTGATTGTTC	0	1
CATACACAGTCTCGAAGCGG	CATACACAGTCTCGAAGCGG	0	1
AGAGCCTGATGTACTGTTGT	AGAGCCTGATGTACTGTTGT	0	1
ATTCCTCGCCTGATCTCGTT	ATTCCTCGCCTGATCTCGTT	0	1
CTTAATGCAAACCTGCTCAG	CTTAATGCAAACCTGCTCAG	0	1
ACTGGCCATACTTGACAGCG	ACTGGCCATACTTGACAGCG	0	1
CACTCACATCGCCCTCGACT	CACTCACATCGCCCTCGACT	0	1
TCCTAAAGACTCATGTCGTT	TCCTAAAGACTCATGTCGTT	0	1
AACCCACGCTTGAGGCCTTG	AACCCACGCTTGAGGCCTTG	0	1
TGTCGCAGTTTTAGAGCTAG	TGTCGCAGTTTTAGAGCTAG	0	1
TCACCATGGCCGCTAGCACT	TCACCATGGCCGCTAGCACT	0	1
GATCTTACCAAGTAATCATG	GATCTTACCAAGTAATCATG	0	1
CCTGCGGAGGACGTTCTGCG	CCTGCGGAGGACGTTCTGCG	0	1
ACAGTCTGAGCAATCGTTTG	ACAGTCTGAGCAATCGTTTG	0	1
CAACTTCTTGCCCAACGTCG	CAACTTCTTGCCCAACGTCG	0	1
ACTGTAGCGACGGCTCTCCG	ACTGTAGCGACGGCTCTCCG	0	3
TACCTTAACATTCCATCCGG	TACCTTAACATTCCATCCGG	0	1
CATTGTTTTGTTGACAATGG	CATTGTTTTGTTGACAATGG	0	1
ACCTGTTATCGTCTTGAAAA	ACCTGTTATCGTCTTGAAAA	0	1
CCCGCACATCAACGCCCTCA	CCCGCACATCAACGCCCTCA	0	1
TTTTGAAGTCTTGCTCCATG	TTTTGAAGTCTTGCTCCATG	0	1
TTGAATGAGCCCGCCGAGCG	TTGAATGAGCCCGCCGAGCG	0	1
AGTGGAATCCCACCATGAGG	AGTGGAATCCCACCATGAGG	0	1
TCGCCAGTAAGCAATCATGC	TCGCCAGTAAGCAATCATGC	0	1
TCTTTTCACTACAATCTCGT	TCTTTTCACTACAATCTCGT	0	1
TACGTCCAGCAAGCTGTCAT	TACGTCCAGCAAGCTGTCAT	0	1
CAGCCTTCGACAAGCCATCG	CAGCCTTCGACAAGCCATCG	0	1
CCGGCTGCTGCAGAAAGCTC	CCGGCTGCTGCAGAAAGCTC	0	1
CCTTCTGTAGCGTGCTCTTC	CCTTCTGTAGCGTGCTCTTC	0	1
CACCTTCGTCCGCTACTGCG	CACCTTCGTCCGCTACTGCG	0	1
CTCTTACCAGGCTGGTCCCT	CTCTTACCAGGCTGGTCCCT	0	1
GACAAAAACACATCCGTGTG	GACAAAAACACATCCGTGTG	0	1
CTATCTCCGTCTGCTCTAAG	CTATCTCCGTCTGCTCTAAG	0	1
CATCCACCGAAGACCATGCC	CATCCACCGAAGACCATGCC	0	1
CAGATCTGATGTCAATGTTG	CAGATCTGATGTCAATGTTG	0	1
TGTCAAGCATGCAATCTTGT	TGTCAAGCATGCAATCTTGT	0	1
TACTTACCACAACAGCTGTA	TACTTACCACAACAGCTGTA	0	1
GGGCCGTGCGCTACCGCCTT	GGGCCGTGCGCTACCGCCTT	0	1
TACCTTCCAGCTGTCTGATT	TACCTTCCAGCTGTCTGATT	0	1
CTGTGCACTGTGTCCTAATC	CTGTGCACTGTGTCCTAATC	0	1
CACGTTTGTAGATGACAATG	CACGTTTGTAGATGACAATG	0	1
GACTATACCTGCATCGGGGC	GACTATACCTGCATCGGGGC	0	1
TGATCTTGGCTGCATCTCAG	TGATCTTGGCTGCATCTCAG	0	1
TTATGACCGCTACCTACGAC	TTATGACCGCTACCTACGAC	0	1
CGCTCTTCTTTACTGCTTTT	CGCTCTTCTTTACTGCTTTT	0	1
ACTACCTGAATCTGTTGACT	ACTACCTGAATCTGTTGACT	0	1
CTCAATGAGTTCAAACAGCA	CTCAATGAGTTCAAACAGCA	0	1
ATCTTTCATGTCGTGACCAG	ATCTTTCATGTCGTGACCAG	0	1
AACAAAGCAGATAATAATGC	AACAAAGCAGATAATAATGC	0	1
TGTTACTATACAGCCCTGCG	TGTTACTATACAGCCCTGCG	0	1
CCAAGCATATGCTGATGTTC	CCAAGCATATGCTGATGTTC	0	1
TGTCTTCACGTCCCCGTTGC	TGTCTTCACGTCCCCGTTGC	0	1
TTTCAGATCAAACTCATCCA	TTTCAGATCAAACTCATCCA	0	1
ACTACATAAGTTTTAGAGCT	ACTACATAAGTTTTAGAGCT	0	1
TCAGCTTCCTTGTCATCGTT	TCAGCTTCCTTGTCATCGTT	0	1
TGGTCATACCGAATTGCATC	TGGTCATACCGAATTGCATC	0	1
AGCCGTCCTGCGTGTCCCGG	AGCCGTCCTGCGTGTCCCGG	0	1
CACCAAGCTCATCAAGTCCA	CACCAAGCTCATCAAGTCCA	0	1
TTCCGGATCCCTCATCTTGT	TTCCGGATCCCTCATCTTGT	0	1
CCCTCAGACATCCGTATATT	CCCTCAGACATCCGTATATT	0	1
CTTGTTGTTTGTTTTAGAGC	CTTGTTGTTTGTTTTAGAGC	0	1
AAGCAACGCGCTCCCCTTCG	AAGCAACGCGCTCCCCTTCG	0	1
TCCTGCTCCGCAGCCACTCA	TCCTGCTCCGCAGCCACTCA	0	1
GGCAGAGCGCACATTGCTCC	GGCAGAGCGCACATTGCTCC	0	1
ATATTTCGTGCCTCAGTCCG	ATATTTCGTGCCTCAGTCCG	0	1
TGCACTAGCATGTTTTCACG	TGCACTAGCATGTTTTCACG	0	1
AAGCCCTTTCATTCTTGTCC	AAGCCCTTTCATTCTTGTCC	0	1
GACGATATGAATGCATCCCG	GACGATATGAATGCATCCCG	0	1
AGGCACGGCTCCATCTTCTT	AGGCACGGCTCCATCTTCTT	0	1
TGTAGACTGAGCAAGTTAAA	TGTAGACTGAGCAAGTTAAA	0	3
GGTTGGAAGAGTTGCTTTGG	GGTTGGAAGAGTTGCTTTGG	0	1
TCTAGTTTTAGAGCTAGAAA	TCTAGTTTTAGAGCTAGAAA	0	1
CTACTTACCGAAGAACCGTA	CTACTTACCGAAGAACCGTA	0	1
GCGCCTACGACAGCAGTCTA	GCGCCTACGACAGCAGTCTA	0	1
CACCTGTGCACACCGATATG	CACCTGTGCACACCGATATG	0	1
CCACGTGGAGGCCGAGAGCA	CCACGTGGAGGCCGAGAGCA	0	1
ATCGCCGATATCAACTTGAA	ATCGCCGATATCAACTTGAA	0	1
ATGCTAGTAGCTTATCCAGT	ATGCTAGTAGCTTATCCAGT	0	1
TTGCTCCAAAGTTTCCTTTT	TTGCTCCAAAGTTTCCTTTT	0	1
CGGCCGCGTGCAAGGCGTCA	CGGCCGCGTGCAAGGCGTCA	0	1
GCAGCCTCTTCACCGATAGT	GCAGCCTCTTCACCGATAGT	0	1
CCTGACTTCATTTGTGTGGT	CCTGACTTCATTTGTGTGGT	0	1
TCCAGAAACCGCATGTATCA	TCCAGAAACCGCATGTATCA	0	1
ACCAATACTTTCTACTCCAG	ACCAATACTTTCTACTCCAG	0	1
TCAGGTATATACAACAATTG	TCAGGTATATACAACAATTG	0	1
ACACGCACAAGCATGACCCT	ACACGCACAAGCATGACCCT	0	1
TTTGTCCGTTATCAACTTGA	TTTGTCCGTTATCAACTTGA	0	1
TTCCGTGACATCTACATCGG	TTCCGTGACATCTACATCGG	0	1
TGCCATACCGAATCCAGTGT	TGCCATACCGAATCCAGTGT	0	1
TCACCTGGAACCACACTGTG	TCACCTGGAACCACACTGTG	0	1
GCCCACTTATAGTGCTGCCG	GCCCACTTATAGTGCTGCCG	0	1
AGCAGCCCCCGCACGCATCT	AGCAGCCCCCGCACGCATCT	0	1
CTTCCAACTTCCCACCGCCC	CTTCCAACTTCCCACCGCCC	0	1
CCTTATGCACTCCCGCTCCG	CCTTATGCACTCCCGCTCCG	0	1
CCTGCCAGTCGACGTCAACG	CCTGCCAGTCGACGTCAACG	0	1
AGACCGTCCGCGAGTCCAGG	AGACCGTCCGCGAGTCCAGG	0	1
GTCCTAGCTGCCAGACCGCG	GTCCTAGCTGCCAGACCGCG	0	1
TTCCTGTCTTTGTCACTAGG	TTCCTGTCTTTGTCACTAGG	0	1
ACCAGATTTGCCGATCTTGC	ACCAGATTTGCCGATCTTGC	0	1
GTGGACGCACGACCCTTCCT	GTGGACGCACGACCCTTCCT	0	1
CGGGCATTCCTGTTCGTTTA	CGGGCATTCCTGTTCGTTTA	0	1
TGTTTGCCATGAGATCTCGT	TGTTTGCCATGAGATCTCGT	0	1
TCACACGTGCGTTAAGGTAC	TCACACGTGCGTTAAGGTAC	0	1
AACATCCCGCACGCGATCTG	AACATCCCGCACGCGATCTG	0	1
AGGCAGGCAGAAATGCTGAC	AGGCAGGCAGAAATGCTGAC	0	1
TGTAATTGTCGTTGTTGTGC	TGTAATTGTCGTTGTTGTGC	0	1
CAGATACCCACCAGCGATTT	CAGATACCCACCAGCGATTT	0	1
TGGTGAACAAGGGGGACTTC	TGGTGAACAAGGGGGACTTC	0	1
TATACAAACTCGCTGAATCG	TATACAAACTCGCTGAATCG	0	1
TTGCAGACCTGTGGTAACAG	TTGCAGACCTGTGGTAACAG	0	1
CCTCGTCTCTCTCCGTGCAC	CCTCGTCTCTCTCCGTGCAC	0	1
TTTTCTAGGACCAAGACCAG	TTTTCTAGGACCAAGACCAG	0	1
TTTGGGGATCCACTCCAAGA	TTTGGGGATCCACTCCAAGA	0	1
GTCTCACCTCTGCACATTTA	GTCTCACCTCTGCACATTTA	0	1
TATGACCGCTTCATCGAGTT	TATGACCGCTTCATCGAGTT	0	1
TCTGTATTATGCTCCCCTCC	TCTGTATTATGCTCCCCTCC	0	1
CCTGCAGCCCACCGTCTACC	CCTGCAGCCCACCGTCTACC	0	1
TACGACCATCTGATTCCCTT	TACGACCATCTGATTCCCTT	0	2
CCGGCTCTCAGAGGAAGCCG	CCGGCTCTCAGAGGAAGCCG	0	1
GTCGACATGTGTTCTCTGTT	GTCGACATGTGTTCTCTGTT	0	1
GCACGTGCCAAGTCACCATG	GCACGTGCCAAGTCACCATG	0	1
CCCTCTGCAGGCGTTCGGTG	CCCTCTGCAGGCGTTCGGTG	0	1
GTCCATGACTTCTGATACAG	GTCCATGACTTCTGATACAG	0	1
TCTCTAGCTCTTTAAGATCC	TCTCTAGCTCTTTAAGATCC	0	1
ACATTGAAAGCCTCGTACCT	ACATTGAAAGCCTCGTACCT	0	1
CGGGCTCCAAACGAATCCTG	CGGGCTCCAAACGAATCCTG	0	1
TCCTAGGGTATAAAGACGCG	TCCTAGGGTATAAAGACGCG	0	1
CCAGCCTTGATTTGATATGC	CCAGCCTTGATTTGATATGC	0	1
TTCTTTAGAGCTAGAAATAG	TTCTTTAGAGCTAGAAATAG	0	1
CAGCTAGAAATAGCAAGTTA	CAGCTAGAAATAGCAAGTTA	0	1
CCCACAACTTGCTCTACTTC	CCCACAACTTGCTCTACTTC	0	1
ACAGCCGCAGTTGTCGAACT	ACAGCCGCAGTTGTCGAACT	0	1
ACTTACCTGAATTATCCAGA	ACTTACCTGAATTATCCAGA	0	1
ACTCACCCCCTGGACAGCGT	ACTCACCCCCTGGACAGCGT	0	1
TATCAGCCGCGTAATATTCT	TATCAGCCGCGTAATATTCT	0	1
ACCATGGTGCGATGCGAACG	ACCATGGTGCGATGCGAACG	0	1
TCCGCAGGGGGATCCGCATG	TCCGCAGGGGGATCCGCATG	0	1
GCGAGACATCTAGAAATAGC	GCGAGACATCTAGAAATAGC	0	2
GGGGCTCACCAATGCATTAC	GGGGCTCACCAATGCATTAC	0	1
GCTCAAATCAGATTGCTCAG	GCTCAAATCAGATTGCTCAG	0	1
CAGCTCTCCACCGATGTCGC	CAGCTCTCCACCGATGTCGC	0	1
TAAGCGTGACCCTACAGCAG	TAAGCGTGACCCTACAGCAG	0	1
CTGCAAGTGTCTGATTTGCC	CTGCAAGTGTCTGATTTGCC	0	1
TTCACCAGCATTGCCGAAGA	TTCACCAGCATTGCCGAAGA	0	1
CTTCGGCCGCGTCCACCATT	CTTCGGCCGCGTCCACCATT	0	1
GCCTTTTTGTACAGATGCTT	GCCTTTTTGTACAGATGCTT	0	1
CCGGGGCGGGAGGTTTAACT	CCGGGGCGGGAGGTTTAACT	0	1
GAGCTCTTCGAGACTCTTGT	GAGCTCTTCGAGACTCTTGT	0	1
TACCTTACCACGTGCAGTAG	TACCTTACCACGTGCAGTAG	0	1
TACCAGTGCCATGTGCAAGG	TACCAGTGCCATGTGCAAGG	0	1
TCAGTTGCAGCACCCACGTT	TCAGTTGCAGCACCCACGTT	0	1
ACGTTTTAGTCGACCTCATC	ACGTTTTAGTCGACCTCATC	0	1
CTGACTTCGCTGCCCACGGG	CTGACTTCGCTGCCCACGGG	0	1
CAACTTACTTACCCACTGGT	CAACTTACTTACCCACTGGT	0	1
CCTAAACAGGGCATCTAGTG	CCTAAACAGGGCATCTAGTG	0	1
TCCACGAGGGTGGCTGACAT	TCCACGAGGGTGGCTGACAT	0	1
CTCCCAAAACCGAGTCGTTG	CTCCCAAAACCGAGTCGTTG	0	1
CCTTCGCTCCTATGCTGTTT	CCTTCGCTCCTATGCTGTTT	0	1
CTTCTTGCAGCCCAAGCTGC	CTTCTTGCAGCCCAAGCTGC	0	1
CACCCACTCACGTTTGGTGC	CACCCACTCACGTTTGGTGC	0	1
GACGAAGGCGGTTGGATGAG	GACGAAGGCGGTTGGATGAG	0	1
CATCTGATGCGCTCAAACCG	CATCTGATGCGCTCAAACCG	0	1
GGCATGCATTTTAGGGATCA	GGCATGCATTTTAGGGATCA	0	1
TCCGCCTGAACAACGCCATT	TCCGCCTGAACAACGCCATT	0	1
GGTACTTCTAGAGCTAGAAA	GGTACTTCTAGAGCTAGAAA	0	1
CAGCTTCTTCGCTCGTCTGT	CAGCTTCTTCGCTCGTCTGT	0	1
TATTGCCGCAGCACGATCAC	TATTGCCGCAGCACGATCAC	0	1
ACTAGCCCATCCCGTCGTTT	ACTAGCCCATCCCGTCGTTT	0	1
TGGATTACAATATCTCCCGT	TGGATTACAATATCTCCCGT	0	1
CCGTTATATGCATACCCGTT	CCGTTATATGCATACCCGTT	0	1
GTCCTCCTGCCCAGTTGTTT	GTCCTCCTGCCCAGTTGTTT	0	1
CCCTTGCCCAGCCCATCATC	CCCTTGCCCAGCCCATCATC	0	1
TGTGGCAGCCATGAGCAACC	TGTGGCAGCCATGAGCAACC	0	1
CCCGATCGTAAATACTTGCC	CCCGATCGTAAATACTTGCC	0	1
AGGCCATTCAGCTGATCGAC	AGGCCATTCAGCTGATCGAC	0	1
CCCTTCCATATTTGCCCCTC	CCCTTCCATATTTGCCCCTC	0	1
GGAGCGCCGCCTATGATGCG	GGAGCGCCGCCTATGATGCG	0	1
TCGTGAAGACCTCTGTACAT	TCGTGAAGACCTCTGTACAT	0	1
TCTTGCAGGAGATCCCGATG	TCTTGCAGGAGATCCCGATG	0	1
GGCCACAAACCTGCTCCCTC	GGCCACAAACCTGCTCCCTC	0	1
GCACTCACCGGTGGTCCTGT	GCACTCACCGGTGGTCCTGT	0	1
ACATCCAACAGCATGATGCC	ACATCCAACAGCATGATGCC	0	1
TGTCTCCATGCCGGATTACC	TGTCTCCATGCCGGATTACC	0	1
TTTTAACAGTCATTCGTTTT	TTTTAACAGTCATTCGTTTT	0	1
CTTACATAGCAAATCTAATG	CTTACATAGCAAATCTAATG	0	1
CTCGGTCGATACTGTAGAAG	CTCGGTCGATACTGTAGAAG	0	1
GCCAAGGAGGCATGCCCACG	GCCAAGGAGGCATGCCCACG	0	1
CAACGCCACCAATTCCAACC	CAACGCCACCAATTCCAACC	0	1
TCCGCAGTGATCCTTTTGTG	TCCGCAGTGATCCTTTTGTG	0	1
GCTGAGCACCAAGCTACTCC	GCTGAGCACCAAGCTACTCC	0	2
TTACCGGTCAGCTGCTATGG	TTACCGGTCAGCTGCTATGG	0	1
TACTCCGTTCCTCATCAAAG	TACTCCGTTCCTCATCAAAG	0	1
TTCTTCCCTTGTTGCATCTG	TTCTTCCCTTGTTGCATCTG	0	1
TGTGACGTCTTCCACCACTG	TGTGACGTCTTCCACCACTG	0	1
CAGCACACTTACCTGTGTCT	CAGCACACTTACCTGTGTCT	0	1
CATATGTTTCAGAGCTAGAA	CATATGTTTCAGAGCTAGAA	0	1
TGTTACAGCCCAGTCCGTTA	TGTTACAGCCCAGTCCGTTA	0	1
TCACTACGACTACGAGCCAC	TCACTACGACTACGAGCCAC	0	1
TTGTAGATCCGCTTGTCAAC	TTGTAGATCCGCTTGTCAAC	0	1
CGACAGCTCAGAGATATCGT	CGACAGCTCAGAGATATCGT	0	1
TCTGATCCCGATATGGTTTA	TCTGATCCCGATATGGTTTA	0	2
CTGGATGCATAGTTGTTTGT	CTGGATGCATAGTTGTTTGT	0	1
CAGCAACACGTGTACCTGCA	CAGCAACACGTGTACCTGCA	0	1
TACCCAGCGGTAGCACTCAC	TACCCAGCGGTAGCACTCAC	0	1
TCGTCCAGGACCTTTGCACG	TCGTCCAGGACCTTTGCACG	0	1
GTCCCCAGTACTTCCCTAAC	GTCCCCAGTACTTCCCTAAC	0	1
CTAGGATCCTTTCAGCAAGT	CTAGGATCCTTTCAGCAAGT	0	1
TGTTTTAAGGAAATCGTGGA	TGTTTTAAGGAAATCGTGGA	0	1
CCTCACTAGCTCTCAGATTC	CCTCACTAGCTCTCAGATTC	0	1
CCCCAATTACTTGTTGCAGT	CCCCAATTACTTGTTGCAGT	0	1
TAGACCGTTATCAATTTGAA	TAGACCGTTATCAATTTGAA	0	1
CTATGACACCCTCAGCCCCT	CTATGACACCCTCAGCCCCT	0	1
CTGGACTATGGTTGCAACTA	CTGGACTATGGTTGCAACTA	0	1
CTTTACCAGTAGTTCGCCCG	CTTTACCAGTAGTTCGCCCG	0	1
CGACTCCATGAAGCTCTCCC	CGACTCCATGAAGCTCTCCC	0	1
CCGACTTCTTCGCCATCGTG	CCGACTTCTTCGCCATCGTG	0	1
TTTCTCGTATATGGTTTAGA	TTTCTCGTATATGGTTTAGA	0	1
ACCATGTCCCCGTGCCTGTC	ACCATGTCCCCGTGCCTGTC	0	1
TCTTACCCTCATCAAAGTGG	TCTTACCCTCATCAAAGTGG	0	1
GAACATAGCACGTTAAAATA	GAACATAGCACGTTAAAATA	0	1
CTGGAGGGGAATCTGGATCC	CTGGAGGGGAATCTGGATCC	0	1
AGCTGTATGCCCAGATGCCT	AGCTGTATGCCCAGATGCCT	0	1
TCCAAGAACCTGCTTCTGTC	TCCAAGAACCTGCTTCTGTC	0	1
CTATCATTGCTGGTCACCTT	CTATCATTGCTGGTCACCTT	0	1
TCTGCTAGATCCTACCATCT	TCTGCTAGATCCTACCATCT	0	1
TAGCCTTGTAGTGCTGAAAT	TAGCCTTGTAGTGCTGAAAT	0	1
TGTATGCAGCCATGACACGT	TGTATGCAGCCATGACACGT	0	1
TCGTGACGATCCGAAGACTG	TCGTGACGATCCGAAGACTG	0	1
TTCTTAGTTGCAGACGCCTG	TTCTTAGTTGCAGACGCCTG	0	1
TCCCTGCCGAGTGCATCGTG	TCCCTGCCGAGTGCATCGTG	0	1
AGCGTTTGGTCCCCACTGCG	AGCGTTTGGTCCCCACTGCG	0	1
CCCGCCTCGTCCAGCAGCGG	CCCGCCTCGTCCAGCAGCGG	0	1
CCTGCTGCCCGTGCGCCTTC	CCTGCTGCCCGTGCGCCTTC	0	1
CCTCCCCGTGTTTGTGACGT	CCTCCCCGTGTTTGTGACGT	0	1
TCCTGCTAAAGGGACCCAAA	TCCTGCTAAAGGGACCCAAA	0	1
TGTTCGACCAGAATCGTGAG	TGTTCGACCAGAATCGTGAG	0	1
GGTATTATTCAAATGCTTAC	GGTATTATTCAAATGCTTAC	0	1
GTGCGACATTCGATGAGTTT	GTGCGACATTCGATGAGTTT	0	1
CTACCCAAAAGTGCGATTTA	CTACCCAAAAGTGCGATTTA	0	1
CAAAGTGATCAGCTACTCTG	CAAAGTGATCAGCTACTCTG	0	1
TACCCCGCCTCCTGTTCCGT	TACCCCGCCTCCTGTTCCGT	0	1
AGCGTGCGCGTGACCCGCAG	AGCGTGCGCGTGACCCGCAG	0	1
CCACTGTGATGACGACGATG	CCACTGTGATGACGACGATG	0	1
AGACAGCTACGACAAAGTGT	AGACAGCTACGACAAAGTGT	0	1
ACGTGGAATTCCCGTTTCAG	ACGTGGAATTCCCGTTTCAG	0	1
TGCACCGAGTCGGTGCTTTT	TGCACCGAGTCGGTGCTTTT	0	1
GTCCATGAGCAGGGCGTAGC	GTCCATGAGCAGGGCGTAGC	0	1
CGCTGGCAGTGTAGACCGTG	CGCTGGCAGTGTAGACCGTG	0	1
ACAGGCCGTTCCTCAACCCC	ACAGGCCGTTCCTCAACCCC	0	1
TTATTGCACAAGTATCTCGG	TTATTGCACAAGTATCTCGG	0	1
AGGCGAGCAGTGCGCCCCTT	AGGCGAGCAGTGCGCCCCTT	0	1
ATGGACACGCAACTGAGCTC	ATGGACACGCAACTGAGCTC	0	1
CTCACATATCTCATATTCCG	CTCACATATCTCATATTCCG	0	1
TAGACCAACAAAGAGTCATC	TAGACCAACAAAGAGTCATC	0	1
CCACACCTCCCTGCGTTTTA	CCACACCTCCCTGCGTTTTA	0	1
GCCGGATTCACAATCGACCT	GCCGGATTCACAATCGACCT	0	1
GTTTTGCGCTCATGTTGACC	GTTTTGCGCTCATGTTGACC	0	1
TACAGTTCATCATCTTGATC	TACAGTTCATCATCTTGATC	0	1
TCGGTGCTCCTCCCATGAAG	TCGGTGCTCCTCCCATGAAG	0	1
TAAGATCTCGGTGGATGATT	TAAGATCTCGGTGGATGATT	0	1
TTAACATCTTCCGCACCACT	TTAACATCTTCCGCACCACT	0	2
GCTGGGTCGATCCTGGTTCG	GCTGGGTCGATCCTGGTTCG	0	1
TCCTCTTTCTTGTCGACGTT	TCCTCTTTCTTGTCGACGTT	0	1
GGCAGGTCACCTCCCGCTCC	GGCAGGTCACCTCCCGCTCC	0	1
GACCGGAAAGTCAGTGTGAA	GACCGGAAAGTCAGTGTGAA	0	1
TGGTACATCGAGTGTCCTGA	TGGTACATCGAGTGTCCTGA	0	1
CCGTGTATATTCGCATGTAG	CCGTGTATATTCGCATGTAG	0	1
ACCTTGCAGAATCCAGTGCC	ACCTTGCAGAATCCAGTGCC	0	1
CTCTTGTCCTGTCATATGAG	CTCTTGTCCTGTCATATGAG	0	1
CGGCAGTGCTAGAGCCTGCG	CGGCAGTGCTAGAGCCTGCG	0	1
CCTAAATCATAGTAGCAAAG	CCTAAATCATAGTAGCAAAG	0	2
ACTCTTGTGGAGTATCTCGA	ACTCTTGTGGAGTATCTCGA	0	1
CCATGTGTACTGAGTTATCA	CCATGTGTACTGAGTTATCA	0	1
TCGAGTGATTCGATTATCTT	TCGAGTGATTCGATTATCTT	0	1
TACCTGACGCGAGTGCCGTT	TACCTGACGCGAGTGCCGTT	0	1
CTCTACCGCTACTCCGTCTC	CTCTACCGCTACTCCGTCTC	0	1
CCGGCATTCGGGCATGCTCC	CCGGCATTCGGGCATGCTCC	0	1
CGTTGTATGCCCGCACTCTG	CGTTGTATGCCCGCACTCTG	0	2
TGCCATGCAATCGATTATGT	TGCCATGCAATCGATTATGT	0	1
GCCAAATCCTTGCTGAAGCA	GCCAAATCCTTGCTGAAGCA	0	1
CGTGTGCTTGCGCGGGGACG	CGTGTGCTTGCGCGGGGACG	0	1
GGGTCAAATAAGGCTAGTCC	GGGTCAAATAAGGCTAGTCC	0	1
CCAGTACATTGAACTCTTAC	CCAGTACATTGAACTCTTAC	0	1
TCCCGATGATCTCGATCCCG	TCCCGATGATCTCGATCCCG	0	1
GGATTCCCTTTCAAGACGAA	GGATTCCCTTTCAAGACGAA	0	1
TTCCAGAGGAGCCTTAAATT	TTCCAGAGGAGCCTTAAATT	0	1
GCGAGTACAGTGCTGTCAGT	GCGAGTACAGTGCTGTCAGT	0	1
TTTGAGTACCCCGACTTCCG	TTTGAGTACCCCGACTTCCG	0	1
TTCTTAATTAAGTTTGATCT	TTCTTAATTAAGTTTGATCT	0	1
GCTCGATGTACCTGTCTTCA	GCTCGATGTACCTGTCTTCA	0	1
CAGGTAGTTCAGTCGCCAAG	CAGGTAGTTCAGTCGCCAAG	0	1
TGCCAGACGTTTTAGAGCTA	TGCCAGACGTTTTAGAGCTA	0	1
CACAGCTTGCCCGCCAGCCG	CACAGCTTGCCCGCCAGCCG	0	1
TTGCGTTTAGAGCTAGAAAT	TTGCGTTTAGAGCTAGAAAT	0	1
TCTGAAACCCCACGACGTTT	TCTGAAACCCCACGACGTTT	0	1
TCCAGACAGTCCTCTGTTTT	TCCAGACAGTCCTCTGTTTT	0	1
CTGTTATCGTCTATTTGTTT	CTGTTATCGTCTATTTGTTT	0	1
ACTGGTCATCGCATGTCAGC	ACTGGTCATCGCATGTCAGC	0	1
CACAACCAAGCCCCCAACGT	CACAACCAAGCCCCCAACGT	0	1
AATCCCTGCCATCCTCATGT	AATCCCTGCCATCCTCATGT	0	1
ATGACTGCCGTGTTTAGAGC	ATGACTGCCGTGTTTAGAGC	0	1
CATCGTCCCTCCGTTGACGG	CATCGTCCCTCCGTTGACGG	0	1
TCACCTCCCCACGTTTAGAG	TCACCTCCCCACGTTTAGAG	0	1
TACCTGTCTACGCAAGTCCT	TACCTGTCTACGCAAGTCCT	0	1
TACCCGACACACTCCACTTG	TACCCGACACACTCCACTTG	0	1
GACCTCCCCTTGCTGTCTCG	GACCTCCCCTTGCTGTCTCG	0	1
GACAGCATTATGGCCCCATG	GACAGCATTATGGCCCCATG	0	1
GCGCGGCATCAACTATGCTT	GCGCGGCATCAACTATGCTT	0	1
ACGGAGAAGTTCCGTTACCA	ACGGAGAAGTTCCGTTACCA	0	1
AACAGTATCCACCAGAGTTT	AACAGTATCCACCAGAGTTT	0	1
CCCTACAGTCTCCAGATCGG	CCCTACAGTCTCCAGATCGG	0	1
TGACACTTGCTGAGACATTT	TGACACTTGCTGAGACATTT	0	1
ATGTCCGTTATCAACTTGAA	ATGTCCGTTATCAACTTGAA	0	1
CGAGGAAAACACGCGAGGTT	CGAGGAAAACACGCGAGGTT	0	1
ACCACACCGCGTAGCCCGTT	ACCACACCGCGTAGCCCGTT	0	1
CAGGTTTCCCACATGCTTCG	CAGGTTTCCCACATGCTTCG	0	1
TAGCGGCCCAGCAGTCTGTC	TAGCGGCCCAGCAGTCTGTC	0	1
CCCAATGAGAAGATCAGTTT	CCCAATGAGAAGATCAGTTT	0	1
GAAGACAAAATGTAGTTCTG	GAAGACAAAATGTAGTTCTG	0	1
CCTCAGCTGTACCGTCTCCG	CCTCAGCTGTACCGTCTCCG	0	1
TAGGCTTGGCATCGCTTGGT	TAGGCTTGGCATCGCTTGGT	0	1
TTTACGACCAGTGCCACATT	TTTACGACCAGTGCCACATT	0	1
TCGCTGTGAAAGACTGCTCC	TCGCTGTGAAAGACTGCTCC	0	1
ACGTTGAGTCACCCCTCTGC	ACGTTGAGTCACCCCTCTGC	0	1
GGTCCGCTAGCCCATCACAG	GGTCCGCTAGCCCATCACAG	0	1
ACGCCGGGAGCAGCGCTATT	ACGCCGGGAGCAGCGCTATT	0	1
TTCATCTACCATTGCTCAGC	TTCATCTACCATTGCTCAGC	0	1
TGACATCGTCAACGCAATCG	TGACATCGTCAACGCAATCG	0	1
GGTTCTCCACATCGTCCCCC	GGTTCTCCACATCGTCCCCC	0	1
CCCCGGGCCGTCAACCTGCA	CCCCGGGCCGTCAACCTGCA	0	1
CGGCTGCACCTTCGACCTTG	CGGCTGCACCTTCGACCTTG	0	1
TTCGCATCGGCACGTCAGCC	TTCGCATCGGCACGTCAGCC	0	1
GGGTCCTTAAAGTTAAAATA	GGGTCCTTAAAGTTAAAATA	0	1
TCCGCCGGAACGCCCGTCGC	TCCGCCGGAACGCCCGTCGC	0	1
CTGTGCCATGTTCCTAGTGG	CTGTGCCATGTTCCTAGTGG	0	1
TCATTGCCCTGCTAATCACG	TCATTGCCCTGCTAATCACG	0	1
GCAGCCTGTAATCTACACCT	GCAGCCTGTAATCTACACCT	0	1
CACTCTTGTTGTAAGAAATG	CACTCTTGTTGTAAGAAATG	0	1
CCGAAGTTCAGCGCGTTAAC	CCGAAGTTCAGCGCGTTAAC	0	1
GAGGATGCCAATCACTTTTG	GAGGATGCCAATCACTTTTG	0	1
CTGTTTCGAAAAGGGCCAGT	CTGTTTCGAAAAGGGCCAGT	0	1
TGATATAGCCCAAGATGCGT	TGATATAGCCCAAGATGCGT	0	1
CCTCATCCACAGCTACGACG	CCTCATCCACAGCTACGACG	0	1
ATCTATCAGCTTCACTGTGT	ATCTATCAGCTTCACTGTGT	0	1
GTCGTTAGTTCTGTCTTCCG	GTCGTTAGTTCTGTCTTCCG	0	1
TGTATTGTCCCCAGGTCTTC	TGTATTGTCCCCAGGTCTTC	0	1
TAGTTGCTGGGAATACGACT	TAGTTGCTGGGAATACGACT	0	1
GCCATGCGACCGCGTGTTTT	GCCATGCGACCGCGTGTTTT	0	1
GAACGTTCTTCTCATCATCG	GAACGTTCTTCTCATCATCG	0	1
TGCTAGATGGCTGAGCCCTT	TGCTAGATGGCTGAGCCCTT	0	1
ACGGTTCCTCCGCCCCTCCT	ACGGTTCCTCCGCCCCTCCT	0	1
GTCCTATGATTAGAGCTAGA	GTCCTATGATTAGAGCTAGA	0	1
CAGATTGCACCGGATCCCAA	CAGATTGCACCGGATCCCAA	0	1
TCGTTTGACATAAGGCTAGT	TCGTTTGACATAAGGCTAGT	0	1
ACCATCGCAACACAACCTCA	ACCATCGCAACACAACCTCA	0	1
CTAAAGAGTCCAGCACCGAG	CTAAAGAGTCCAGCACCGAG	0	1
TGCGCGCCCAGACCGAGCTG	TGCGCGCCCAGACCGAGCTG	0	1
CTGCCATCCAACGTGGCACC	CTGCCATCCAACGTGGCACC	0	1
TTGCCGCTGTCCGTGAACCG	TTGCCGCTGTCCGTGAACCG	0	1
TACCTGAAGAGACCGCAAGG	TACCTGAAGAGACCGCAAGG	0	1
CCCTCGAACGATCAGCTCCG	CCCTCGAACGATCAGCTCCG	0	1
TCCCGTGACTCATGAAACAC	TCCCGTGACTCATGAAACAC	0	1
ACGCCAACCGGCTCACCGAA	ACGCCAACCGGCTCACCGAA	0	1
CCATGGTCCAGCATTCATGT	CCATGGTCCAGCATTCATGT	0	1
TGACATTTGCTGTGCATCTC	TGACATTTGCTGTGCATCTC	0	1
GCCTCAATGACTTCTTGCAT	GCCTCAATGACTTCTTGCAT	0	1
CCTCGAGTACTTAGCTCTCG	CCTCGAGTACTTAGCTCTCG	0	1
TGAATACCAACCAATGCGTC	TGAATACCAACCAATGCGTC	0	1
TCCCAGCAGCAGCTGCTCTG	TCCCAGCAGCAGCTGCTCTG	0	1
GTGAAAATTAAGCCAGACCG	GTGAAAATTAAGCCAGACCG	0	1
GCATGCGGTCATGATGAATG	GCATGCGGTCATGATGAATG	0	1
GCAGGTGCGTGATGGCTGGG	GCAGGTGCGTGATGGCTGGG	0	1
GTACTGGATCCTATGAAGCT	GTACTGGATCCTATGAAGCT	0	1
TGATGAAAGTTCTACTCTCG	TGATGAAAGTTCTACTCTCG	0	1
GCCGACGCACCACCTTTGTG	GCCGACGCACCACCTTTGTG	0	1
ACCTCGCGTATTCGTCTCGT	ACCTCGCGTATTCGTCTCGT	0	1
CTTCTCGAACATGTCTCGCG	CTTCTCGAACATGTCTCGCG	0	1
TACCTTACCACGTGCAGCAG	TACCTTACCACGTGCAGCAG	0	1
TACCCTTTTACTGATAAAGC	TACCCTTTTACTGATAAAGC	0	1
TGCCGGATTCTCCTTGATTG	TGCCGGATTCTCCTTGATTG	0	1
CAGCGCCACGATCCGCGATA	CAGCGCCACGATCCGCGATA	0	1
CAATGTTGTCAACTTGAAAA	CAATGTTGTCAACTTGAAAA	0	1
AGTAGAGGATACGTACCTGT	AGTAGAGGATACGTACCTGT	0	2
TGCCGGTGTCATCGCATTTG	TGCCGGTGTCATCGCATTTG	0	1
ACGCCAACTTGCTCACCGAA	ACGCCAACTTGCTCACCGAA	0	1
CAGCTGGCACAAACTTCGTT	CAGCTGGCACAAACTTCGTT	0	1
CAGTCCTTCAATCCAACTTG	CAGTCCTTCAATCCAACTTG	0	1
CTATATGTACAGCGGCCACA	CTATATGTACAGCGGCCACA	0	1
AGAACGGTCCATCCGCCGCT	AGAACGGTCCATCCGCCGCT	0	1
CTTGACAACTCTCTCTAACG	CTTGACAACTCTCTCTAACG	0	1
TCATGCTCCGAAGCCACTAA	TCATGCTCCGAAGCCACTAA	0	1
ACATCCCCGGAATCAACCTC	ACATCCCCGGAATCAACCTC	0	1
GGGCAGTGACCCGTCCGTTA	GGGCAGTGACCCGTCCGTTA	0	1
GGTCATGTTCAGTCCAACTG	GGTCATGTTCAGTCCAACTG	0	1
TGACTTCATCGGGCCGTCTT	TGACTTCATCGGGCCGTCTT	0	1
ACTCACCTGCACGTAGCCAA	ACTCACCTGCACGTAGCCAA	0	1
GAGAATATCCAGTGATTCTT	GAGAATATCCAGTGATTCTT	0	1
TTCTATGCACTCTCGCTCCG	TTCTATGCACTCTCGCTCCG	0	1
AGTGCCTTAATTGATTCTGT	AGTGCCTTAATTGATTCTGT	0	1
CGTGTGTTTTAGAGCTAGAA	CGTGTGTTTTAGAGCTAGAA	0	1
CTATGTGATCAATGTGACGT	CTATGTGATCAATGTGACGT	0	1
GCAGACATCCGGGCATTGTG	GCAGACATCCGGGCATTGTG	0	1
TCATTATACAGACAATACCT	TCATTATACAGACAATACCT	0	1
CACCTAGCTCCTCTCGTGCT	CACCTAGCTCCTCTCGTGCT	0	1
CCTGAACCGTCTGGCTTTGG	CCTGAACCGTCTGGCTTTGG	0	1
GATGGTTGTGCAGCGGTTTT	GATGGTTGTGCAGCGGTTTT	0	1
TATGCATTCCCACGTCACTG	TATGCATTCCCACGTCACTG	0	1
GAGGCGCTGATGCTTGGGGA	GAGGCGCTGATGCTTGGGGA	0	1
TCAACCTGTACCAAAACTGT	TCAACCTGTACCAAAACTGT	0	1
AACAGGTGCGGGAACCAAGT	AACAGGTGCGGGAACCAAGT	0	1
TTACCTGGGCTCTCCCCCTC	TTACCTGGGCTCTCCCCCTC	0	1
GAACCTTGAGAGATTCTTTG	GAACCTTGAGAGATTCTTTG	0	1
CACACGACAGCAGCCGCCCG	CACACGACAGCAGCCGCCCG	0	1
GGCATAACTCACTGTGTGCG	GGCATAACTCACTGTGTGCG	0	1
CCTAAGTAATCATGAATTTG	CCTAAGTAATCATGAATTTG	0	1
CGCCATAGAAGAACGCTTCG	CGCCATAGAAGAACGCTTCG	0	1
CGAGGCAGTAGCCCACATCG	CGAGGCAGTAGCCCACATCG	0	1
GGCGGCAACCAAGTTGAAAA	GGCGGCAACCAAGTTGAAAA	0	1
CAGAGACATGTCACGCAGTC	CAGAGACATGTCACGCAGTC	0	1
AGCGTTCATCTCCAGTTACA	AGCGTTCATCTCCAGTTACA	0	1
CGAACCATCGTTCTTGCTAG	CGAACCATCGTTCTTGCTAG	0	1
CAGTTTCTTACCTTTGCCGC	CAGTTTCTTACCTTTGCCGC	0	1
CACATGTTGACTCCCTTCTG	CACATGTTGACTCCCTTCTG	0	1
GTTCTGGGCCATGTGCCATC	GTTCTGGGCCATGTGCCATC	0	1
TCCCTCACCCTGAAAAAGTG	TCCCTCACCCTGAAAAAGTG	0	1
TGGGTCTGACTGTCTACCAT	TGGGTCTGACTGTCTACCAT	0	1
CTGCCTTGAGTCCAGTTCTG	CTGCCTTGAGTCCAGTTCTG	0	1
ATAAACTCACCAATACGTGG	ATAAACTCACCAATACGTGG	0	1
TGAAAGCTACACCCATTGAG	TGAAAGCTACACCCATTGAG	0	1
ACTGTTGCACTGTCTGATGT	ACTGTTGCACTGTCTGATGT	0	1
TGAGAGCGATTTGTGATGTG	TGAGAGCGATTTGTGATGTG	0	1
ACGGGGGTCAAGTTTCTCGT	ACGGGGGTCAAGTTTCTCGT	0	1
TGGATATAAAGCGCATTCTG	TGGATATAAAGCGCATTCTG	0	1
ACTGTCATACAGATGTAGGT	ACTGTCATACAGATGTAGGT	0	1
CCAAAGGTCTTCAACCTGAG	CCAAAGGTCTTCAACCTGAG	0	1
TCTCGAAAAAGACGTTATCA	TCTCGAAAAAGACGTTATCA	0	1
CATGCCTTACCGTCATGGTG	CATGCCTTACCGTCATGGTG	0	1
TTACACCTTGCTGTGATGTC	TTACACCTTGCTGTGATGTC	0	1
TACGAACCGCCAGCGTTTTA	TACGAACCGCCAGCGTTTTA	0	1
GGAAGACAGAAATAGCAAGT	GGAAGACAGAAATAGCAAGT	0	1
TCTCCACAACGTGTGTCACC	TCTCCACAACGTGTGTCACC	0	1
CTCCATTTATGCCCACAGTT	CTCCATTTATGCCCACAGTT	0	1
TAAGTCCGCAGAATCGTTTA	TAAGTCCGCAGAATCGTTTA	0	1
CAAGAGACTACAGATAACAA	CAAGAGACTACAGATAACAA	0	1
CTTGAACAAACCTTGATCCG	CTTGAACAAACCTTGATCCG	0	1
TACCTGGCTGCAAAGACCTG	TACCTGGCTGCAAAGACCTG	0	1
TGTAGAGGATCCTGCCCTCT	TGTAGAGGATCCTGCCCTCT	0	1
TGTAGTATCATAGTGATTCG	TGTAGTATCATAGTGATTCG	0	1
TGCCGCAGTTTTAGAGCTAG	TGCCGCAGTTTTAGAGCTAG	0	1
ACAGGCTTGCCGTGCCTCGT	ACAGGCTTGCCGTGCCTCGT	0	1
CCGTCTTCGAGCTAGAAATA	CCGTCTTCGAGCTAGAAATA	0	1
CAACCATTCTGGATCTCAGC	CAACCATTCTGGATCTCAGC	0	1
TGATGGCTCCGATGAGTCCC	TGATGGCTCCGATGAGTCCC	0	1
TGCCGCGAGGTACCGCTACC	TGCCGCGAGGTACCGCTACC	0	1
ACAGTCGGGAGTCATCTGTT	ACAGTCGGGAGTCATCTGTT	0	1
TGACTGTCAGCGACGTCCGT	TGACTGTCAGCGACGTCCGT	0	1
CTCCACTTCCAATTGTCTAG	CTCCACTTCCAATTGTCTAG	0	1
CTCACGCTTACCATCATGAA	CTCACGCTTACCATCATGAA	0	1
ACCCATACAGACTCTCGCCG	ACCCATACAGACTCTCGCCG	0	1
CCGCACAACTTAAGAAGTGT	CCGCACAACTTAAGAAGTGT	0	1
CTCACGGATCCGGCCGTTTG	CTCACGGATCCGGCCGTTTG	0	1
TCCTCGACACCCTTCCATTC	TCCTCGACACCCTTCCATTC	0	1
ACTCAACACTTTTGTCAATT	ACTCAACACTTTTGTCAATT	0	1
AGCAGCCTGTCAAAACTGAG	AGCAGCCTGTCAAAACTGAG	0	1
CATAGAAGGAGACGTGTTCC	CATAGAAGGAGACGTGTTCC	0	1
ATGGTGAAGAGCTAGAAATA	ATGGTGAAGAGCTAGAAATA	0	1
TCACACCATATCTTCTTCGT	TCACACCATATCTTCTTCGT	0	1
TTCGATATACAAACAAATGT	TTCGATATACAAACAAATGT	0	1
AAGGAAGATATAGAAATCTC	AAGGAAGATATAGAAATCTC	0	1
TCGATGTGTTCAATAATGTG	TCGATGTGTTCAATAATGTG	0	1
GACAGCTTTATTAAACCGCT	GACAGCTTTATTAAACCGCT	0	1
GTCAGTGCCCTATTGTAACG	GTCAGTGCCCTATTGTAACG	0	1
CCGTATCGCCCCTCATGTTT	CCGTATCGCCCCTCATGTTT	0	1
TCCTTACCCAGTACCTAAAC	TCCTTACCCAGTACCTAAAC	0	1
TACCTCCTCCGACACCCGTT	TACCTCCTCCGACACCCGTT	0	1
CATCTATCCACCATCAGCGG	CATCTATCCACCATCAGCGG	0	1
GTCTTGTCGTAGGCGAACAG	GTCTTGTCGTAGGCGAACAG	0	1
CAGCCCTTTCATTCTTGTCC	CAGCCCTTTCATTCTTGTCC	0	1
CTTTAGAACGGCTCATCACG	CTTTAGAACGGCTCATCACG	0	1
TCCTTGGAGCACCCGACATC	TCCTTGGAGCACCCGACATC	0	1
CGTACCGCAGATTGAAACTG	CGTACCGCAGATTGAAACTG	0	1
CTATTCAGTGTATGCGTACA	CTATTCAGTGTATGCGTACA	0	1
TTCAATATCTTCACCCAGCT	TTCAATATCTTCACCCAGCT	0	1
AAGCTTACCTGGTCTAGTTG	AAGCTTACCTGGTCTAGTTG	0	1
ACTCGGGTTGCATATCCTAG	ACTCGGGTTGCATATCCTAG	0	1
TTTGCATCTCTGTTGACCGG	TTTGCATCTCTGTTGACCGG	0	1
CCCCTCAATGACCTCATGTT	CCCCTCAATGACCTCATGTT	0	1
TCACCCACCCCATCTTGTTT	TCACCCACCCCATCTTGTTT	0	1
TGCGTTTTTGAGCTAGAAAT	TGCGTTTTTGAGCTAGAAAT	0	1
TAATGACGTGAAGAAAGCAG	TAATGACGTGAAGAAAGCAG	0	1
TTAATTGTTTCCTAAATTTT	TTAATTGTTTCCTAAATTTT	0	1
CTCTTACCAGGCAGGTCCTC	CTCTTACCAGGCAGGTCCTC	0	1
GCCCGTATTGGGCTTGCACG	GCCCGTATTGGGCTTGCACG	0	1
GCTTCTGGCGTGCGTCTCTG	GCTTCTGGCGTGCGTCTCTG	0	1
GTTCGAATTACTCCTCTGTT	GTTCGAATTACTCCTCTGTT	0	1
ATTTCTGCGCTTCATCCCTG	ATTTCTGCGCTTCATCCCTG	0	1
ATTATTGACCGTATCTTCTG	ATTATTGACCGTATCTTCTG	0	1
TCCTCAGGGTACTACGGCGG	TCCTCAGGGTACTACGGCGG	0	1
CAGCAAGTTAAAATAAGGCT	CAGCAAGTTAAAATAAGGCT	0	1
GAAATTCTTGCGCTGAACTG	GAAATTCTTGCGCTGAACTG	0	1
CGCGCACACCCGCTCGGCTG	CGCGCACACCCGCTCGGCTG	0	1
CCGCCTCACTGTGACATCAG	CCGCCTCACTGTGACATCAG	0	1
AGTTACCAGTGCCAATACCT	AGTTACCAGTGCCAATACCT	0	1
CTTGTGAACAGCTGCCATCT	CTTGTGAACAGCTGCCATCT	0	1
CCCCGCCTTGCCCCCGACGC	CCCCGCCTTGCCCCCGACGC	0	1
TCCACTTTGAGCTACAACGG	TCCACTTTGAGCTACAACGG	0	1
GGTAGTTCACCACCTCCTGC	GGTAGTTCACCACCTCCTGC	0	1
CTGAGCTGCATGCTATAGAG	CTGAGCTGCATGCTATAGAG	0	1
GAAGGAACTGAGCCTGGATT	GAAGGAACTGAGCCTGGATT	0	1
AGCGCGCAAAGAGTTGCCAG	AGCGCGCAAAGAGTTGCCAG	0	1
CTCGCTTTCCATCCACGTTT	CTCGCTTTCCATCCACGTTT	0	1
TTACTCAACTGCCGGGATCG	TTACTCAACTGCCGGGATCG	0	1
TAGGCGGTAATTAATCGTTT	TAGGCGGTAATTAATCGTTT	0	1
ACTTTCCCTGCGCCTCATCT	ACTTTCCCTGCGCCTCATCT	0	1
CGCGAGATGACCGCTTCGCG	CGCGAGATGACCGCTTCGCG	0	1
CGTAACATCAGCACGTTGTT	CGTAACATCAGCACGTTGTT	0	1
TGCCTACACGACAACAGCCG	TGCCTACACGACAACAGCCG	0	1
CATCGTACCTCCGATGACGG	CATCGTACCTCCGATGACGG	0	1
TCGGTTTAGGGGCTTCGGCG	TCGGTTTAGGGGCTTCGGCG	0	1
TGGCACGGTGACGTTGAGAC	TGGCACGGTGACGTTGAGAC	0	1
AGGCTATTCCGTTATCAACT	AGGCTATTCCGTTATCAACT	0	1
CCGGAGGTTTGTACGGCTTT	CCGGAGGTTTGTACGGCTTT	0	1
TCCTCTGGCATCAACATAAC	TCCTCTGGCATCAACATAAC	0	1
AACCTCCCACTGACCAGTTT	AACCTCCCACTGACCAGTTT	0	1
TCTAATTGGACCAACCTTTA	TCTAATTGGACCAACCTTTA	0	1
CGAAAACCCTGCAATTAGAG	CGAAAACCCTGCAATTAGAG	0	1
GACAGCAGTAACACCAGTCT	GACAGCAGTAACACCAGTCT	0	1
CGGCTCAGCTGGTATGACCT	CGGCTCAGCTGGTATGACCT	0	1
TTTTGTCAGTGCTTGACCCG	TTTTGTCAGTGCTTGACCCG	0	1
CATCAAAACAGCGTGACTCG	CATCAAAACAGCGTGACTCG	0	1
CACACCTTGTACTCCGTGGT	CACACCTTGTACTCCGTGGT	0	1
TTCATCTTCCGCACCACGTT	TTCATCTTCCGCACCACGTT	0	1
CCATGGCTATCTGACCCACG	CCATGGCTATCTGACCCACG	0	1
GCTCAATGTAGGAGCCAGCG	GCTCAATGTAGGAGCCAGCG	0	1
TTTCTCCTAAGGCTAGTCCG	TTTCTCCTAAGGCTAGTCCG	0	1
TTCTCACATTCAGCACACGT	TTCTCACATTCAGCACACGT	0	1
TCCTCGATGACCGCACCGCG	TCCTCGATGACCGCACCGCG	0	1
TCTTCCTTTCTTCATGCCCG	TCTTCCTTTCTTCATGCCCG	0	1
ACTGCGTCAACATCCGCACG	ACTGCGTCAACATCCGCACG	0	1
ACAGCGCCGAGAGTTTTAGA	ACAGCGCCGAGAGTTTTAGA	0	1
AGTGGAGACGTTTTAGAGCT	AGTGGAGACGTTTTAGAGCT	0	1
GCCAAGCATGCTAAACCTGG	GCCAAGCATGCTAAACCTGG	0	1
TACCAGTTTCTGCTCCCCGT	TACCAGTTTCTGCTCCCCGT	0	1
TGCATTTTAGCAGCTTCCAG	TGCATTTTAGCAGCTTCCAG	0	1
TTTTAATAGGCTGAGTCAAG	TTTTAATAGGCTGAGTCAAG	0	1
TGTGCCACGCATCACCGACT	TGTGCCACGCATCACCGACT	0	1
CGCCGCCCCGGACAACTGTC	CGCCGCCCCGGACAACTGTC	0	1
ACCCCTGCTTTGACAGTGCT	ACCCCTGCTTTGACAGTGCT	0	1
CGCGTTGTGCCCTACCTTTG	CGCGTTGTGCCCTACCTTTG	0	1
TTTGGACATCTACTCCTTGT	TTTGGACATCTACTCCTTGT	0	1
GAACAGCACAGTTGTTTGTA	GAACAGCACAGTTGTTTGTA	0	1
TGCGTACCGGGTCTGACGCG	TGCGTACCGGGTCTGACGCG	0	1
ATCTCTTATACACTCCGAAG	ATCTCTTATACACTCCGAAG	0	1
GCCGTCAGCACCCCGCTAGT	GCCGTCAGCACCCCGCTAGT	0	1
CGGCAAGCCAGTCTCCCTCG	CGGCAAGCCAGTCTCCCTCG	0	1
GAGAAGAATGGGCAGACCAG	GAGAAGAATGGGCAGACCAG	0	1
CGTGACCCTCTTCTTCCATG	CGTGACCCTCTTCTTCCATG	0	1
ACAGCCGTACCGTGCGCATT	ACAGCCGTACCGTGCGCATT	0	1
GATCTTATAGGCCGTTTAGG	GATCTTATAGGCCGTTTAGG	0	1
CGACTTCTTGTCATCCACGT	CGACTTCTTGTCATCCACGT	0	1
CCTAAATCATAGTATCAAAG	CCTAAATCATAGTATCAAAG	0	1
CAATATCGAAGAGATCCTGA	CAATATCGAAGAGATCCTGA	0	1
ATCGAACTCAGCAAGCAATT	ATCGAACTCAGCAAGCAATT	0	1
ACGGTCCCCTGGCAACGTGG	ACGGTCCCCTGGCAACGTGG	0	1
CCTGAAGAACAACAGTGCGT	CCTGAAGAACAACAGTGCGT	0	1
CGATTTGAGTTTACCCACGG	CGATTTGAGTTTACCCACGG	0	1
TGCTCATCAGATTTGCACAG	TGCTCATCAGATTTGCACAG	0	1
CCATTCCATCCGCCTGCTCC	CCATTCCATCCGCCTGCTCC	0	1
TCCAAACAGTGTCGAAGTTG	TCCAAACAGTGTCGAAGTTG	0	1
AGGCATCGTGCCCGCAGCTC	AGGCATCGTGCCCGCAGCTC	0	1
CTCTTCGCATGGCATCTGCG	CTCTTCGCATGGCATCTGCG	0	1
ACCTGGAGGTGGGCGTCGTT	ACCTGGAGGTGGGCGTCGTT	0	1
CCAGCAATTTCCTCCCAACG	CCAGCAATTTCCTCCCAACG	0	1
CTGAGCCCCCGATTCAGTCC	CTGAGCCCCCGATTCAGTCC	0	1
GTTCCACAGCCCCATCCTCT	GTTCCACAGCCCCATCCTCT	0	1
TCACTGCCGAGTGCACCGTG	TCACTGCCGAGTGCACCGTG	0	1
TTCGGGCCAGTGCTGGACAT	TTCGGGCCAGTGCTGGACAT	0	1
TGTGATGATGGAGGTCGGTC	TGTGATGATGGAGGTCGGTC	0	1
TGATTACGTCCTCACCTCGG	TGATTACGTCCTCACCTCGG	0	1
GATAGCAGTTAACATAAGGC	GATAGCAGTTAACATAAGGC	0	1
GTTTTACCGTTGCATCGTGG	GTTTTACCGTTGCATCGTGG	0	1
TCACATTTATGTCACCCAGT	TCACATTTATGTCACCCAGT	0	1
TGACAGGGAGGAGGAAACTT	TGACAGGGAGGAGGAAACTT	0	1
TGTCCTGCAGTTAACTCAGT	TGTCCTGCAGTTAACTCAGT	0	1
TAGCACTTGCTGTAGACCCG	TAGCACTTGCTGTAGACCCG	0	1
GATGGAGAAGACAGCGTACT	GATGGAGAAGACAGCGTACT	0	1
TCAGCTCCTGCAGTTTCTTG	TCAGCTCCTGCAGTTTCTTG	0	1
CCCGTTGTACCAGCCACGAG	CCCGTTGTACCAGCCACGAG	0	1
CCTGTTGCCCGCCGCCTGCA	CCTGTTGCCCGCCGCCTGCA	0	1
TCTTCGATTCTCAAAGTGTT	TCTTCGATTCTCAAAGTGTT	0	1
GTCCTTTGAAGAATTCTTTC	GTCCTTTGAAGAATTCTTTC	0	1
ACCTTTGAATCTCCCCAGCT	ACCTTTGAATCTCCCCAGCT	0	1
CGTCCTGTAGTTGTCCCCCC	CGTCCTGTAGTTGTCCCCCC	0	1
